!!ATOK_TANGO_TEXT_HEADER_1
あいたつや	阿井達也	固有一般
あいかわしんや	相川進也	固有一般
あいざわしょうた	相澤祥太	固有一般
あいざわたかし	相澤貴志	固有一般
あいざわぴーたーこあみ	相澤ピーターコアミ	固有一般
あいざわゆうや	相澤佑哉	固有一般
あいだゆうき	相田勇樹	固有一般
あいづゆうき	会津雄生	固有一般
あいはらしょうへい	粟飯原尚平	固有一般
あいばみずき	饗庭瑞生	固有一般
あえこういち	阿江孝一	固有一般
あおえしゅんすけ	青江俊祐	固有一般
あおきありま	青木安里磨	固有一般
あおきこうた	青木孝太	固有一般
あおきこころ	青木心	固有一般
あおきしゅんた	青木駿汰	固有一般
あおきしょう	青木捷	固有一般
あおきしょうた	青木翔大	固有一般
あおきそうま	青木想真	固有一般
あおきたくま	青木拓真	固有一般
あおきたくや	青木拓矢	固有一般
あおきたけし	青木剛	固有一般
あおきつばさ	青木翼	固有一般
あおきはやと	青木駿人	固有一般
あおきひろと	青木洋翔	固有一般
あおきまさむね	青木正宗	固有一般
あおきゆうすけ	青木友佑	固有一般
あおきよしたか	青木義孝	固有一般
あおきりく	青木陸	固有一般
あおきりょうた	青木亮太	固有一般
あおきりょうた	青木良太	固有一般
あおしまたいち	青島太一	固有一般
あおしまたくま	青島拓馬	固有一般
あおしまふみあき	青嶋文明	固有一般
あおしまゆうや	青嶋佑弥	固有一般
あおたしょう	青田翔	固有一般
あおとかける	青戸翔	固有一般
あおのいぶき	青野聖樹	固有一般
あおのだいすけ	青野大介	固有一般
あおばゆきひろ	青葉幸洋	固有一般
あおやぎごう	青柳仰	固有一般
あおやまいきる	青山生	固有一般
あおやまじゅん	青山隼	固有一般
あおやまとしひろ	青山敏弘	固有一般
あおやまなおあき	青山直晃	固有一般
あおやまひろあき	青山景昌	固有一般
あおやまゆうすけ	青山夕祐	固有一般
あかいしゅういち	赤井秀一	固有一般
あかいひでゆき	赤井秀行	固有一般
あかおあきら	赤尾公	固有一般
あかおよしのぶ	赤尾佳宣	固有一般
あかぎなおと	赤木直人	固有一般
あかぎはると	赤木陽翔	固有一般
あかさかけいや	赤坂渓也	固有一般
あかさきしゅうへい	赤﨑秀平	固有一般
あかすまなと	赤須真登	固有一般
あかつかみかえる	赤塚ミカエル	固有一般
あかつかれい	赤塚怜	固有一般
あかほしかいま	赤星魁麻	固有一般
あかほしたかふみ	赤星貴文	固有一般
あかほしたく	赤星拓	固有一般
あかほしゆうすけ	赤星雄祐	固有一般
あかまつしゅうや	赤松秀哉	固有一般
あかみねしんご	赤嶺真吾	固有一般
あきぎんじ	安芸銀治	固有一般
あきまさとし	安藝正俊	固有一般
あきしげりんたろう	秋重凛太朗	固有一般
あきたひでよし	秋田英義	固有一般
あきたまさてる	秋田政輝	固有一般
あきたみずき	秋田深月	固有一般
あきたゆたか	秋田豊	固有一般
あきのひろき	秋野央樹	固有一般
あきばただひろ	秋葉忠宏	固有一般
あきばのぶひで	秋葉信秀	固有一般
あきばまさる	秋葉勝	固有一般
あきばよういち	秋葉陽一	固有一般
あきばりゅうじ	秋葉竜児	固有一般
あきもとたかひろ	明本考浩	固有一般
あきもとまさひろ	秋元雅博	固有一般
あきもとみちたか	秋本倫孝	固有一般
あきもとようた	秋元陽太	固有一般
あきもりれん	秋守蓮	固有一般
あきやましゅん	秋山駿	固有一般
あきやまたかし	秋山貴嗣	固有一般
あきやまたくや	秋山拓也	固有一般
あきやまだいち	秋山大地	固有一般
あきやまとらのすけ	秋山虎之亮	固有一般
あきやまひろき	秋山裕紀	固有一般
あきやまようすけ	秋山陽介	固有一般
あきよしたいすけ	秋吉泰佑	固有一般
あけひともひろ	明比友宏	固有一般
あげいしるい	揚石琉生	固有一般
あげつましゅうと	揚妻秀斗	固有一般
あさいかずき	浅井一希	固有一般
あさいかずひこ	浅井一彦	固有一般
あさいかんた	浅井寛大	固有一般
あさいこうすけ	浅井昂介	固有一般
あさいとしみつ	浅井俊光	固有一般
あさかわはやと	浅川隼人	固有一般
あさかわまさき	浅川将輝	固有一般
あさくらそう	朝倉爽	固有一般
あさくらのりあき	朝倉徳明	固有一般
あさくられん	浅倉廉	固有一般
あさだしょうご	麻田将吾	固有一般
あさだだいき	浅田大樹	固有一般
あさぬますぐる	浅沼優瑠	固有一般
あさぬまたつや	浅沼達也	固有一般
あさのかおる	浅野薫	固有一般
あさのかつき	浅野克己	固有一般
あさのたくま	浅野拓磨	固有一般
あさのてつや	浅野哲也	固有一般
あさのなおき	浅野直希	固有一般
あさのゆうや	浅野雄也	固有一般
あさひだいすけ	朝日大輔	固有一般
あさひなしん	朝比奈伸	固有一般
あさみともき	朝見友樹	固有一般
あさりさとる	浅利悟	固有一般
あしのしょうと	芦野翔斗	固有一般
あしべこうせい	芦部晃生	固有一般
あすけしょう	足助翔	固有一般
あずまけいご	東桂吾	固有一般
あずまひろき	東博樹	固有一般
あずまひろし	東浩史	固有一般
あそうしゅん	麻生瞬	固有一般
あだちかいと	足立快斗	固有一般
あだちかずき	安達一貴	固有一般
あだちけんたろう	安達健太郎	固有一般
あだちさく	安達朔	固有一般
あだちしゅうと	安達秀都	固有一般
あだちつばさ	足立翼	固有一般
あだちひろひで	足立丈英	固有一般
あだちゆう	足立優	固有一般
あつかわのりまさ	熱川徳政	固有一般
あつたまこと	熱田眞	固有一般
あつみえいすけ	渥美瑛亮	固有一般
あずまひろまさ	吾妻弘将	固有一般
あのまひろ	阿野真拓	固有一般
あびこたかまさ	安彦考真	固有一般
あぴあたうぃあひさし	アピアタウィア久	固有一般
あぴっちあきら	アピッチ輝	固有一般
あべかいと	阿部海斗	固有一般
あべかいと	阿部海大	固有一般
あべかずき	阿部一樹	固有一般
あべかなと	阿部要門	固有一般
あべくうや	阿部空矢	固有一般
あべけんさく	阿部謙作	固有一般
あべこうと	阿部航斗	固有一般
あべしゅう	阿部嵩	固有一般
あべしゅうと	安部柊斗	固有一般
あべしょうへい	阿部翔平	固有一般
あべたいせい	安部大晴	固有一般
あべたかし	安部崇士	固有一般
あべたくま	阿部拓馬	固有一般
あべたくみ	阿部巧	固有一般
あべてつや	阿部哲也	固有一般
あべとしゆき	阿部敏之	固有一般
あべのぶゆき	阿部伸行	固有一般
あべはやと	阿部隼人	固有一般
あべはると	阿部遥人	固有一般
あべひかる	阿部輝	固有一般
あべひろき	安部裕葵	固有一般
あべひろゆき	阿部浩之	固有一般
あべぶんいちろう	阿部文一朗	固有一般
あべまさのり	阿部正紀	固有一般
あべまひろ	阿部真尋	固有一般
あべみなほ	阿部水帆	固有一般
あべゆういち	安部雄一	固有一般
あべゆうき	阿部勇樹	固有一般
あべゆうき	阿部優	固有一般
あべゆうた	安部雄大	固有一般
あべゆうたろう	阿部祐大朗	固有一般
あべよしのり	阿部良則	固有一般
あべよしろう	阿部吉朗	固有一般
あべらいせい	阿部来誠	固有一般
あべりゅうのすけ	阿部龍之介	固有一般
あべりょうや	阿部諒弥	固有一般
あまがさたいき	天笠泰輝	固有一般
あまねゆうき	天根勇輝	固有一般
あまのこうた	天野恒太	固有一般
あまのじゅん	天野純	固有一般
あまのたかし	天野貴史	固有一般
あまのゆうき	天野悠貴	固有一般
あまのゆうしん	天野友心	固有一般
あまのりゅうせい	天野瑠成	固有一般
あもうりょうすけ	天羽良輔	固有一般
あゆかわしゅん	鮎川峻	固有一般
あらたかふみ	荒貴史	固有一般
あらいいっき	新井一耀	固有一般
あらいかいせい	荒井海聖	固有一般
あらいかんた	荒井貫太	固有一般
あらいけんじ	新井健二	固有一般
あらいしゅうが	荒井秀賀	固有一般
あらいしょうた	新井章太	固有一般
あらいしょうた	新井翔太	固有一般
あらいじゅんぺい	新井純平	固有一般
あらいたいき	新井泰貴	固有一般
あらいたつのり	新居辰基	固有一般
あらいたつや	新井辰也	固有一般
あらいなおと	新井直登	固有一般
あらいなおと	新井直人	固有一般
あらいはやと	新井隼利	固有一般
あらいはるき	新井晴樹	固有一般
あらいひかる	新井光	固有一般
あらいひであき	新井秀明	固有一般
あらいひろと	新井博人	固有一般
あらいみきひと	新井幹人	固有一般
あらいみずき	新井瑞希	固有一般
あらいゆうた	新井悠太	固有一般
あらいゆうた	荒井悠汰	固有一般
あらいよしあき	新井栄聡	固有一般
あらいりょうへい	新井涼平	固有一般
あらいばとおる	新井場徹	固有一般
あらかきたかゆき	新垣貴之	固有一般
あらかわそうま	荒川颯磨	固有一般
あらかわとわ	荒川永遠	固有一般
あらきけんと	荒木健斗	固有一般
あらきしゅうた	荒木秀太	固有一般
あらきしゅんた	荒木駿汰	固有一般
あらきしゅんた	荒木駿太	固有一般
あらきしょう	荒木翔	固有一般
あらきだいご	荒木大吾	固有一般
あらきはやと	荒木隼人	固有一般
あらきりょうすけ	荒木亮輔	固有一般
あらきりょうた	荒木遼太	固有一般
あらきりょうたろう	荒木遼太郎	固有一般
あらきるい	荒木琉偉	固有一般
あらたしげき	荒田成貴	固有一般
あらたともゆき	荒田智之	固有一般
あらたにひろき	荒谷弘樹	固有一般
あらたまえいる	新玉瑛琉	固有一般
あらのたくま	荒野拓馬	固有一般
あらぼりけんじ	荒堀謙次	固有一般
ありしまなお	有島那音	固有一般
ありぞのしんご	有薗真吾	固有一般
ありたけいと	有田恵人	固有一般
ありたこうき	有田光希	固有一般
ありたりょう	有田稜	固有一般
ありながかずき	有永一生	固有一般
ありまけんじ	有馬賢二	固有一般
ありまげんき	有馬弦希	固有一般
ありまこうたろう	有馬幸太郎	固有一般
ありまじゅん	有間潤	固有一般
ありみずあき	有水亮	固有一般
ありみつくひろ	有光空大	固有一般
ありみつりょうた	有光亮太	固有一般
ありむらこうじ	有村光史	固有一般
ありむらしゅうと	有村柊人	固有一般
あわかしゅんた	阿波加俊太	固有一般
あわたりしんや	阿渡真也	固有一般
あわのけんと	粟野健翔	固有一般
あんじゅんそ	安 俊洙	固有一般
あんじょんふぁん	安貞桓	固有一般
あんそんじん	安鮮鎮	固有一般
あんひょよん	安孝錬	固有一般
あんびょんじゅん	安柄俊	固有一般
あんよんう	安庸佑	固有一般
あんよんはく	安 英学	固有一般
あんざいかいと	安西海斗	固有一般
あんざいかずき	安在和樹	固有一般
あんざいこうき	安西幸輝	固有一般
あんざいそうま	安斎颯馬	固有一般
あんざいたつや	安在達弥	固有一般
あんだらい	按田頼	固有一般
あんどうあおい	安藤阿雄依	固有一般
あんどうあきら	安東輝	固有一般
あんどうかずや	安藤一哉	固有一般
あんどうこうせい	安藤虎星	固有一般
あんどうしゅんすけ	安藤駿介	固有一般
あんどうしゅんや	安藤駿冶	固有一般
あんどうじゅん	安藤淳	固有一般
あんどうだいすけ	安東大介	固有一般
あんどうつばさ	安藤翼	固有一般
あんどうてる	安東輝	固有一般
あんどうとしき	安藤寿岐	固有一般
あんどうともや	安藤智哉	固有一般
あんどうともやす	安藤智安	固有一般
あんどうなおと	安藤由翔	固有一般
あんどうまさひろ	安藤正裕	固有一般
あんどうみずき	安藤瑞季	固有一般
あんどうりゅうせい	安藤竜星	固有一般
あんらくけんた	安楽健太	固有一般
いがんじん	李 康珍	固有一般
いきじ	李 記帝	固有一般
いぐの	李根鎬	固有一般
いじょんす	李  正秀	固有一般
いじょんみん	李鍾民	固有一般
いせうんひ	李 承熙	固有一般
いちゅんす	李天秀	固有一般
いどんみょん	李 東明	固有一般
いほう	李浩	固有一般
いほせうん	李 昊乗	固有一般
いみょんじゃ	李明載	固有一般
いいりょうま	伊井涼馬	固有一般
いいおかずのり	飯尾一慶	固有一般
いいおかずや	飯尾和也	固有一般
いいおりゅうたろう	飯尾竜太朗	固有一般
いいくらひろき	飯倉大樹	固有一般
いいけしょうご	伊池翔吾	固有一般
いいじまかずひさ	飯島寿久	固有一般
いいじまりく	飯島陸	固有一般
いいずみりょうや	飯泉涼矢	固有一般
いいだしょうご	飯田正吾	固有一般
いいだたかひろ	飯田貴敬	固有一般
いいだたつみ	飯田健巳	固有一般
いいだひろたか	飯田絋孝	固有一般
いいだまさき	飯田真輝	固有一般
いいだまさひろ	飯田雅浩	固有一般
いいだゆうじ	飯田優二	固有一般
いいだりくと	飯田陸斗	固有一般
いいだりょう	飯田涼	固有一般
いいづかだいち	飯塚大地	固有一般
いいづかひろき	飯塚浩記	固有一般
いいづかよしひと	飯塚欣士	固有一般
いいのじゅお	飯野珠央	固有一般
いいのななせい	飯野七聖	固有一般
いいのまさとし	飯野雅俊	固有一般
いいむらたいき	飯村太基	固有一般
いいむろりょうた	飯室綾太	固有一般
いいやまゆうご	飯山悠吾	固有一般
いえいずみれい	家泉怜依	固有一般
いえながあきひろ	家長昭博	固有一般
いおかかいと	井岡海都	固有一般
いがらしあらた	五十嵐新	固有一般
いかりあすま	碇明日麻	固有一般
いかりのかずま	碇野壱馬	固有一般
いかわはるき	井川晴貴	固有一般
いがらしえいと	五十嵐瑛都	固有一般
いがらしかいと	五十嵐海斗	固有一般
いがらしかずや	五十嵐和也	固有一般
いがらしたいよう	五十嵐太陽	固有一般
いがらしだいご	五十嵐大悟	固有一般
いがらしまさと	五十嵐理人	固有一般
いがりあゆむ	猪狩歩望	固有一般
いがりゆうき	猪狩佑貴	固有一般
いがわそら	井川空	固有一般
いがわゆうすけ	井川祐輔	固有一般
いきつしょうじ	生津将司	固有一般
いぐちりくと	井口綾人	固有一般
いけうちともひこ	池内友彦	固有一般
いけがみじょうじ	池上丈二	固有一般
いけがみれいいち	池上礼一	固有一般
いけがやぎんじろう	池谷銀姿郎	固有一般
いけがやはやと	池ヶ谷颯斗	固有一般
いけたかのぶき	池髙暢希	固有一般
いけだけい	池田圭	固有一般
いけだこう	池田航	固有一般
いけだしゅうじ	池田修志	固有一般
いけだしゅんた	池田春汰	固有一般
いけだしょうへい	池田昇平	固有一般
いけだじゅらと	池田樹雷人	固有一般
いけだたくみ	池田拓海	固有一般
いけだたつや	池田達哉	固有一般
いけだとうや	池田任泰	固有一般
いけだのぶやす	池田伸康	固有一般
いけだふとし	池田太	固有一般
いけだほまれ	池田誉	固有一般
いけだまこと	池田誠	固有一般
いけだまさき	池田昌生	固有一般
いけだまさひろ	池田昌広	固有一般
いけだまなぶ	池田学	固有一般
いけだまもる	池田衛	固有一般
いけだゆずき	池田柚生	固有一般
いけだれん	池田廉	固有一般
いけながわたる	池永航	固有一般
いけにわりょうや	池庭諒耶	固有一般
いけのうえしゅんいち	池ノ上俊一	固有一般
いけはたようすけ	池端陽介	固有一般
いけまかなう	池間叶	固有一般
いけまつしゅんぺい	池末瞬平	固有一般
いけまつひであき	池松秀明	固有一般
いけもとともき	池元友樹	固有一般
いけもとはる	池本晴	固有一般
いけもとゆう	池本優	固有一般
いけやともき	池谷友喜	固有一般
いけやゆうすけ	池谷祐輔	固有一般
いこまけい	生駒稀生	固有一般
いこまじん	生駒仁	固有一般
いさこうへい	伊佐耕平	固有一般
いさかけんた	井坂健太	固有一般
いさかてっぺい	井坂鉄平	固有一般
いざわあつし	井澤惇	固有一般
いざわしゅうと	伊澤翔登	固有一般
いざわそうへい	伊澤壮平	固有一般
いざわはるき	井澤春輝	固有一般
いしいかいせい	石井快征	固有一般
いしいけいた	石井圭太	固有一般
いしいけんご	石井謙伍	固有一般
いしいけんた	石井健太	固有一般
いしいこうき	石井光輝	固有一般
いしいそうじろう	石井壯二郎	固有一般
いしいたいせい	石井大生	固有一般
いしいとしや	石井俊也	固有一般
いしいはやた	石井隼太	固有一般
いしいひさつぐ	石井久継	固有一般
いしいひでのり	石井秀典	固有一般
いしいひでゆき	石井秀幸	固有一般
いしいひゅうま	石井飛雄馬	固有一般
いしいまさただ	石井正忠	固有一般
いしいゆうすけ	石井雄輔	固有一般
いしいりゅうせい	石井琉晟	固有一般
いしいりょう	石井僚	固有一般
いしいりょう	石井綾	固有一般
いしうらたいが	石浦大雅	固有一般
いしおりくと	石尾陸登	固有一般
いしおりょうが	石尾崚雅	固有一般
いしかわあおい	石川蒼生	固有一般
いしかわあおと	石川碧人	固有一般
いしかわけい	石川慧	固有一般
いしかわけん	石川研	固有一般
いしかわけんたろう	石川健太郎	固有一般
いしかわげんだい	石川玄大	固有一般
いしかわこう	石川 康	固有一般
いしかわじょうじ	石川丈慈	固有一般
いしかわせいた	石川晴大	固有一般
いしかわたかお	石川喬穂	固有一般
いしかわたつや	石川竜也	固有一般
いしかわだいち	石川大地	固有一般
いしかわとしき	石川俊輝	固有一般
いしかわなおき	石川直樹	固有一般
いしかわなおと	石川直人	固有一般
いしかわなおひろ	石川直宏	固有一般
いしかわなるき	石川成希	固有一般
いしかわひろき	石川大稀	固有一般
いしかわひろと	石川啓人	固有一般
いしかわひろのり	石川大徳	固有一般
いしかわまさひろ	石川雅博	固有一般
いしかわゆうじ	石川裕司	固有一般
いしかわりゅうた	石川隆汰	固有一般
いしがきのりゆき	石垣徳之	固有一般
いしがみこうせい	石神幸征	固有一般
いしかみしょうま	石上将馬	固有一般
いしがみなおや	石神直哉	固有一般
いしがみわたる	石上航	固有一般
いしかめあきら	石亀晃	固有一般
いしがもりそうま	石ヶ森荘真	固有一般
いしぐろともひさ	石黒智久	固有一般
いしげひでき	石毛秀樹	固有一般
いしざかげんき	石坂元気	固有一般
いしざかりょうと	石坂亮人	固有一般
いしざきりょう	石崎諒	固有一般
いしざわのりあき	石澤典明	固有一般
いしずえりゅうじ	石末龍治	固有一般
いしたにごいち	石谷吾一	固有一般
いしだこうた	石田皓大	固有一般
いしだはやと	石田隼将	固有一般
いしだひでゆき	石田英之	固有一般
いしだひろゆき	石田博行	固有一般
いしだまさと	石田雅人	固有一般
いしだまさとし	石田雅俊	固有一般
いしだゆうき	石田祐樹	固有一般
いしだゆうすけ	石田侑資	固有一般
いしだりょうたろう	石田凌太郎	固有一般
いしだりょうま	石田崚真	固有一般
いしだれいや	石田怜也	固有一般
いしだてやすき	石舘靖樹	固有一般
いしづかい	石津快	固有一般
いしづだいすけ	石津大介	固有一般
いしづかけいじ	石塚啓次	固有一般
いしづかしん	石塚心	固有一般
いしどうかずと	石堂和人	固有一般
いしどうけいた	石堂圭太	固有一般
いしはらかつや	石原克哉	固有一般
いしはらすかい	石原澄海	固有一般
いしはらたかよし	石原崇兆	固有一般
いしはらたく	石原卓	固有一般
いしはらだいすけ	石原大助	固有一般
いしはらなおき	石原直樹	固有一般
いしはらひろかず	石原広教	固有一般
いしはらみらん	石原未蘭	固有一般
いしばしなおき	石橋直希	固有一般
いしばしふみや	石橋郁弥	固有一般
いしびつようすけ	石櫃洋祐	固有一般
いしまたいせい	石間大誠	固有一般
いしまるきよたか	石丸清隆	固有一般
いしみねこうや	石嶺幸也	固有一般
いしもりぜん	石森禅	固有一般
いしやまあおぞら	石山青空	固有一般
いしわまさと	石輪聖人	固有一般
いしわたあさひ	石渡旭	固有一般
いしわたりねるそん	石渡ネルソン	固有一般
いずましど	出間思努	固有一般
いずみさいき	泉彩稀	固有一般
いずみそうたろう	泉宗太郎	固有一般
いずみたかあき	泉孝明	固有一般
いずみとうや	泉柊椰	固有一般
いずみはやて	和泉颯	固有一般
いずみゆうや	泉悠哉	固有一般
いずみりゅうじ	和泉竜司	固有一般
いずみさわじん	泉澤仁	固有一般
いずもりりょうた	泉森涼太	固有一般
いせこう	伊勢航	固有一般
いせわたる	伊勢渉	固有一般
いそえたいせい	磯江太勢	固有一般
いそがいひろみつ	礒貝洋光	固有一般
いそがやかしん	磯ヶ谷佳心	固有一般
いそざきけいた	磯崎敬太	固有一般
いそざきまく	磯﨑麻玖	固有一般
いそだよしかず	礒田由和	固有一般
いそののぶひさ	磯野修久	固有一般
いそべかんた	磯部勘太	固有一般
いそむらりょうた	磯村亮太	固有一般
いそもといそもと	磯本蒼羽	固有一般
いそやまかずし	磯山和司	固有一般
いたきれん	板木蓮	固有一般
いたくらこう	板倉滉	固有一般
いたくらたく	板倉洸	固有一般
いたのよしたつ	板野圭竜	固有一般
いたはしようせい	板橋洋青	固有一般
いちはるき	市晴貴	固有一般
いちかわあきのり	市川暉記	固有一般
いちかわけいた	市川恵多	固有一般
いちかわけんしろう	市川健志郎	固有一般
いちかわたいち	市河太一	固有一般
いちかわだいすけ	市川大祐	固有一般
いちかわまさひこ	市川雅彦	固有一般
いちかわゆうま	市川侑麻	固有一般
いちきりゅういち	一木立一	固有一般
いちのいたかひと	一井賢人	固有一般
いちのせたいじゅ	一瀬大寿	固有一般
いちのせとうや	一瀬透也	固有一般
いちはらひろし	市原大嗣	固有一般
いちはらみつき	市原充喜	固有一般
いちはらりおん	市原吏音	固有一般
いちはらりょうた	市原亮太	固有一般
いちまるみずき	市丸瑞希	固有一般
いちみかずなり	一美和成	固有一般
いちみやけんた	一宮憲太	固有一般
いちむらあつし	市村篤司	固有一般
いちむらしんのすけ	市村慎之介	固有一般
いちもりじゅん	一森純	固有一般
いちやなぎゆうご	一柳夢吾	固有一般
いづつりくや	井筒陸也	固有一般
いでけい	井手圭	固有一般
いでけいた	井出敬大	固有一般
いではるや	井出遥也	固有一般
いでまなと	井手真渚人	固有一般
いでぐちじゅん	井手口純	固有一般
いでぐちまさあき	井手口正昭	固有一般
いでぐちようすけ	井手口陽介	固有一般
いといみさき	糸井岬	固有一般
いとうあきら	伊藤彰	固有一般
いとうあつき	伊藤敦樹	固有一般
いとうあつし	伊藤淳嗣	固有一般
いとうかずき	伊藤和基	固有一般
いとうけい	伊藤慧	固有一般
いとうけいすけ	伊藤恵亮	固有一般
いとうけんじ	伊藤健次	固有一般
いとうけんた	伊藤研太	固有一般
いとうげんた	伊藤元太	固有一般
いとうこうき	伊東倖希	固有一般
いとうこうき	伊藤晃希	固有一般
いとうこうた	伊藤康太	固有一般
いとうこじろう	伊藤小次郎	固有一般
いとうごう	伊藤剛	固有一般
いとうしのぶ	伊藤仁	固有一般
いとうしゅん	伊東俊	固有一般
いとうしょう	伊藤翔	固有一般
いとうしんご	伊東真吾	固有一般
いとうしんのすけ	伊東進之輔	固有一般
いとうじゅんや	伊藤純也	固有一般
いとうじゅんや	伊東純也	固有一般
いとうすぐる	伊藤卓	固有一般
いとうそうま	伊藤颯真	固有一般
いとうたいよう	伊藤太陽	固有一般
いとうたかみつ	伊藤駿光	固有一般
いとうたくま	伊藤拓真	固有一般
いとうたくみ	伊藤拓巳	固有一般
いとうたくや	伊藤琢矢	固有一般
いとうたくや	伊藤卓弥	固有一般
いとうだいすけ	伊藤大介	固有一般
いとうだん	伊藤壇	固有一般
いとうてつや	伊藤哲也	固有一般
いとうてるよし	伊東輝悦	固有一般
いとうともひこ	伊藤友彦	固有一般
いとうひろき	伊藤宏樹	固有一般
いとうひろき	伊藤洋輝	固有一般
いとうまきと	伊藤槙人	固有一般
いとうゆうじ	伊藤裕二	固有一般
いとうゆうせい	伊藤優世	固有一般
いとうゆうた	伊藤優汰	固有一般
いとうゆうた	伊藤友太	固有一般
いとうゆきとし	伊東幸敏	固有一般
いとうゆたか	伊藤雄教	固有一般
いとうゆづき	伊藤優津樹	固有一般
いとうりゅうじ	伊藤竜司	固有一般
いとうりゅうすけ	伊藤隆介	固有一般
いとうりゅうせい	伊藤龍生	固有一般
いとうりゅうと	伊藤隆人	固有一般
いとうりょうすけ	伊藤稜介	固有一般
いとうりょうせい	伊東稜晟	固有一般
いとうりょうたろう	伊藤涼太郎	固有一般
いとうりょうま	伊藤稜馬	固有一般
いとうりょうや	伊藤遼哉	固有一般
いとうるい	伊藤琉偉	固有一般
いとがつばさ	糸賀大翼	固有一般
いとはらこうしろう	糸原紘史郎	固有一般
いとやまじん	糸山仁	固有一般
いながきあつし	稲垣 篤志	固有一般
いながきしょう	稲垣祥	固有一般
いながきひろゆき	稲垣博行	固有一般
いながきゆうた	稲垣雄太	固有一般
いながわあおき	稲川碧希	固有一般
いながわはる	稲川暖大	固有一般
いなだこうじ	稲田康志	固有一般
いなずみだいすけ	稲積大介	固有一般
いなばあがし	稲葉亜我志	固有一般
いなばがく	稲葉楽	固有一般
いなばしゅうと	稲葉修土	固有一般
いなばひさひと	稲葉久人	固有一般
いなふくたく	稲福卓	固有一般
いなみじゅん	伊波純	固有一般
いなみせな	井波靖奈	固有一般
いなみてつゆき	稲見哲行	固有一般
いなむらはやと	稲村隼翔	固有一般
いなもとじゅんいち	稲本潤一	固有一般
いなもりかつなお	稲森克尚	固有一般
いぬいたかし	乾貴士	固有一般
いぬいたかや	乾貴哉	固有一般
いぬいたつろう	乾達朗	固有一般
いぬいだいち	乾大知	固有一般
いぬかいともや	犬飼智也	固有一般
いぬかいゆうや	犬飼裕哉	固有一般
いぬづかゆうすけ	犬塚友輔	固有一般
いのぶんた	井野文太	固有一般
いのうえあつし	井上敦史	固有一般
いのうえかずま	井上和馬	固有一般
いのうえかんた	井上寛太	固有一般
いのうえけんた	井上健太	固有一般
いのうえこう	井上巧	固有一般
いのうえこうき	井上航希	固有一般
いのうえこうへい	井上公平	固有一般
いのうえしおん	井上潮音	固有一般
いのうえしおん	井上詩音	固有一般
いのうえしょうた	井上翔太	固有一般
いのうえしょうた	井上湘太	固有一般
いのうえじょう	井上丈	固有一般
いのうえせいや	井上征哉	固有一般
いのうえせいや	井上聖也	固有一般
いのうえたいら	井上平	固有一般
いのうえとき	井上斗希	固有一般
いのうえなおき	井上直輝	固有一般
いのうえひかる	井上輝	固有一般
いのうえひでと	井上秀人	固有一般
いのうえみき	井上樹	固有一般
いのうえめぐむ	井上恵武	固有一般
いのうえもとなり	井上源就	固有一般
いのうえゆうき	井上雄幾	固有一般
いのうえゆうだい	井上裕大	固有一般
いのうえゆうと	井上雄斗	固有一般
いのうえりきと	井上黎生人	固有一般
いのうえりょうが	井上亮雅	固有一般
いのうえりょうた	井上竜太	固有一般
いのうえりょうた	井上亮太	固有一般
いのうえりょうたろう	井上椋太郎	固有一般
いのうえれん	井上怜	固有一般
いのうえわたる	井上渉	固有一般
いのおたくみ	井ノ尾匠	固有一般
いのこしゆい	猪越優惟	固有一般
いのせこうすけ	猪瀬康介	固有一般
いのはまさひこ	伊野波雅彦	固有一般
いのりりょうま	禱涼真	固有一般
いはたしょうたろう	井畑翔太郎	固有一般
いはらしんたろう	井原伸太郎	固有一般
いはらまさみ	井原正巳	固有一般
いはらやすひで	井原康秀	固有一般
いばこうたろう	射庭康太朗	固有一般
いばたひろやす	井幡博康	固有一般
いばやしあきら	井林章	固有一般
いびしゅんと	揖斐俊斗	固有一般
いぶすきひろし	指宿洋史	固有一般
いほりかずあき	井堀二昭	固有一般
いまいかんた	今井勘太	固有一般
いまいけいた	今井啓太	固有一般
いまいしょうた	今井昌太	固有一般
いまいだいご	今井大悟	固有一般
いまいともき	今井智基	固有一般
いまいはやと	今井颯人	固有一般
いまかけこうき	今掛航貴	固有一般
いまかねゆめと	今金夢斗	固有一般
いまがわまさき	今川正樹	固有一般
いまがわもとき	今川元樹	固有一般
いまくらひでゆき	今倉秀之	固有一般
いませじゅんや	今瀬淳也	固有一般
いまぜきこうへい	今関耕平	固有一般
いまづゆうた	今津佑太	固有一般
いまふくけんのり	今福剣之典	固有一般
いむらゆうき	今村優貴	固有一般
いむらゆうすけ	今村優介	固有一般
いむらゆうすけ	今村勇介	固有一般
いむらりくと	今村陸人	固有一般
いむらりょういち	今村涼一	固有一般
いまよしこうへい	今吉晃平	固有一般
りんどんひゅん	林東賢	固有一般
りんようかん	林裕煥	固有一般
いもとたかし	井本喬士	固有一般
いよはおさむへんりー	イヨハ理ヘンリー	固有一般
いよりけいたろう	伊従啓太郎	固有一般
いりいかずひさ	入井和久	固有一般
いりえしょうた	入江将太	固有一般
いりえとおる	入江徹	固有一般
いりえとしかず	入江利和	固有一般
いりえゆうじん	入江優仁	固有一般
いりふねかずま	入船和真	固有一般
いるまがわけいた	入間川景太	固有一般
いわいあつひろ	岩井厚裕	固有一般
いわいしゅうや	岩井柊弥	固有一般
いわいりょうま	磐井稜真	固有一般
いわおけん	岩尾憲	固有一般
いわかべひろや	岩壁裕也	固有一般
いわかみゆうぞう	岩上祐三	固有一般
いわかわはるひこ	岩川晴彦	固有一般
いわきだいすけ	岩城大助	固有一般
いわぎしそうし	岩岸宗志	固有一般
いわくらかずや	岩倉一弥	固有一般
いわさきかずさ	岩﨑 知瑳	固有一般
いわさきけいご	岩崎圭吾	固有一般
いわさきゆうと	岩崎悠人	固有一般
いわさきようへい	岩﨑陽平	固有一般
いわさきりょうま	岩崎涼馬	固有一般
いわさわきりと	岩澤桐人	固有一般
いわさわとおる	岩澤徹	固有一般
いわざきかいが	岩﨑海駕	固有一般
いわさきやすゆき	岩崎泰之	固有一般
いわしたけいすけ	岩下敬輔	固有一般
いわしたじゅん	岩下潤	固有一般
いわしたわたる	岩下航	固有一般
いわせけん	岩瀬健	固有一般
いわせごう	磐瀬剛	固有一般
いわたこうき	岩田康貴	固有一般
いわたしょうた	岩田正太	固有一般
いわたたくや	岩田拓也	固有一般
いわたともき	岩田智輝	固有一般
いわたまさひろ	岩田昌浩	固有一般
いわたけかつや	岩武克弥	固有一般
いわだてなお	岩舘直	固有一般
いわだてゆうや	岩舘侑哉	固有一般
いわながそうた	岩永創太	固有一般
いわなみたくや	岩波拓也	固有一般
いわぬましゅんすけ	岩沼俊介	固有一般
いわねりゅうた	岩根隆大	固有一般
いわぶちひろと	岩渕弘人	固有一般
いわぶちりょうた	岩渕良太	固有一般
いわまけいた	岩間慶太	固有一般
いわまゆうだい	岩間雄大	固有一般
いわまさだいき	岩政大樹	固有一般
いわまるふみや	岩丸史也	固有一般
いわもとあいと	岩元愛翔	固有一般
いわもとかずき	岩本和希	固有一般
いわもとしょう	岩本翔	固有一般
いわもとしょうご	岩本昇悟	固有一般
いわもとてるお	岩本輝雄	固有一般
いわもとともゆき	岩本知幸	固有一般
いわもとひろなり	岩元洋成	固有一般
いわもとゆうだい	岩本侑大	固有一般
いわもとゆうや	岩本悠也	固有一般
いわもとりゅうおりびえ	岩元颯オリビエ	固有一般
いわもとりょう	岩本陵	固有一般
いわもとるな	岩元ルナ	固有一般
うさんほ	禹相皓	固有一般
うしょうそ	呉少聰	固有一般
うえびすかつのり	上夷克典	固有一般
うえおかりく	上岡陸	固有一般
うえくさゆうき	植草裕樹	固有一般
うえさとかずま	上里一将	固有一般
うえさとたくみ	上里琢文	固有一般
うえじょさとき	上門知樹	固有一般
うえたけゆうた	植竹優太	固有一般
うえだあやせ	上田綺世	固有一般
うえだいつき	上田樹	固有一般
うえだきょうへい	上田恭平	固有一般
うえだけいすけ	植田圭祐	固有一般
うえだけいた	植田啓太	固有一般
うえだけんと	上田健斗	固有一般
うえだこうた	上田康太	固有一般
うえだこうへい	上田航平	固有一般
うえだしゅんすけ	植田峻佑	固有一般
うえだともき	上田智輝	固有一般
うえだなおみち	植田直通	固有一般
うえだはやと	上田駿斗	固有一般
うえだゆうき	上田侑輝	固有一般
うえだゆうき	上田悠起	固有一般
うえだゆうた	植田悠太	固有一般
うえだりゅうじろう	植田龍仁朗	固有一般
うえだりゅうほ	上田龍朋	固有一般
うえだりょうや	上田陵弥	固有一般
うえなかあさひ	植中朝日	固有一般
うえにしはるき	上西遥喜	固有一般
うえのあきと	上野輝人	固有一般
うえのえいた	上野瑛太	固有一般
うえのけんと	上野賢人	固有一般
うえのそうた	上野綜太	固有一般
うえののぶひろ	上野展裕	固有一般
うえのひであき	上野秀章	固有一般
うえのゆうさく	上野優作	固有一般
うえのよしはる	上野良治	固有一般
うえのりゅうのすけ	上野隆之介	固有一般
うえのやまかなた	上野山叶夢	固有一般
うえはたうへいじ	上畑佑平士	固有一般
うえはらえどうぃん	上原 エドウィン	固有一般
うえはらしんや	上原慎也	固有一般
うえはらたくろう	上原拓郎	固有一般
うえはらまきと	上原牧人	固有一般
うえはらりきや	上原力也	固有一般
うえまつよう	上松瑛	固有一般
うえむらえいいち	植村映一	固有一般
うえむらけい	植村慶	固有一般
うえむらけんいち	上村健一	固有一般
うえむらしゅういち	植村修一	固有一般
うえむらすすむ	植村晋	固有一般
うえむらたかし	上村崇士	固有一般
うえむらともや	植村友哉	固有一般
うえむらひろと	植村洋斗	固有一般
うえむらみさき	上村岬	固有一般
うえもとぎんた	上本銀太	固有一般
うえもとたいかい	上本大海	固有一般
うえもとだいき	植本大貴	固有一般
うおざとなおや	魚里直哉	固有一般
うかいりょうた	鵜飼亮多	固有一般
うがじんともや	宇賀神友弥	固有一般
うきてつろう	浮氣哲郎	固有一般
うきたけんせい	浮田健誠	固有一般
うさがわまお	宇佐川眞央	固有一般
うさみたかし	宇佐美貴史	固有一般
うさみひろかず	宇佐美宏和	固有一般
うしこしたいが	牛越大河	固有一般
うしざわけん	牛澤健	固有一般
うしのはまたく	牛之濵拓	固有一般
うしばなけん	牛鼻健	固有一般
うじいえたかし	氏家貴士	固有一般
うじいえひでゆき	氏家英行	固有一般
うじはらりょうじ	氏原良二	固有一般
うすいかんた	臼井貫太	固有一般
うすいけんぺい	碓井健平	固有一般
うすいこうへい	臼井幸平	固有一般
うすいしょうせい	碓井聖生	固有一般
うすみせいりょう	宇水聖凌	固有一般
うすいてっぺい	碓井鉄平	固有一般
うすいはると	臼井春翔	固有一般
うすいはると	薄井覇斗	固有一般
うすいひとし	臼井仁志	固有一般
うすばはやと	薄葉迅人	固有一般
うたかかいと	宇高魁人	固有一般
うだこうしろう	宇田光史朗	固有一般
うちがしまたくみ	内賀嶋巧	固有一般
うちこしたいき	打越大樹	固有一般
うちぞのひろたか	内薗大貴	固有一般
うちだあつと	内田篤人	固有一般
うちだかずし	内田和志	固有一般
うちだきょうへい	内田恭兵	固有一般
うちだけんた	内田健太	固有一般
うちだこうすけ	内田昂輔	固有一般
うちだこうすけ	内田康介	固有一般
うちだこうへい	内田航平	固有一般
うちだしゅうと	内田修人	固有一般
うちだじゅん	内田潤	固有一般
うちだたくや	内田宅哉	固有一般
うちだたつや	内田達也	固有一般
うちだだいき	内田大貴	固有一般
うちだてっぺい	内田哲兵	固有一般
うちだとしひろ	内田利広	固有一般
うちだともや	内田智也	固有一般
うちだみずき	内田瑞己	固有一般
うちだゆうせい	内田優晟	固有一般
うちだゆうと	内田裕斗	固有一般
うちだれんぺい	内田錬平	固有一般
うちだてひでき	内舘秀樹	固有一般
うちのこうたろう	内野航太郎	固有一般
うちのたかし	内野貴志	固有一般
うちばやしひろたか	内林広高	固有一般
うちぼりたいき	内堀太貴	固有一般
うちまやすみち	内間安路	固有一般
うちむらよしひろ	内村圭宏	固有一般
うちむらりんたろう	内村凜太朗	固有一般
うちやまけい	内山圭	固有一般
うちやまこうき	内山航紀	固有一般
うちやましょうた	内山翔太	固有一般
うちやまじゅん	内山純	固有一般
うちやまたくみ	内山拓海	固有一般
うちやまとしひこ	内山俊彦	固有一般
うちやまゆうき	内山裕貴	固有一般
うつみあおと	内海碧斗	固有一般
うつみしゅうき	内海柊輝	固有一般
うつみはるき	内海陽樹	固有一般
うつもとしんや	宇津元伸弥	固有一般
うどうむう	有働夢叶	固有一般
うねおけんしん	畝尾拳槙	固有一般
うのぜんと	宇野禅斗	固有一般
うのきふみや	鵜木郁哉	固有一般
うのざわゆうじ	宇野沢祐次	固有一般
うまこしひかる	馬越晃	固有一般
うめいだいき	梅井大輝	固有一般
うめきけんと	梅木絢都	固有一般
うめきつばさ	梅木翼	固有一般
うめきれい	梅木怜	固有一般
うめさきつかさ	梅崎司	固有一般
うめざわたかし	梅澤貴史	固有一般
うめざわまなぶ	梅澤学	固有一般
うめだかいと	梅田凱斗	固有一般
うめだかいと	梅田魁人	固有一般
うめだたかし	梅田高志	固有一般
うめだとうご	梅田透吾	固有一般
うめだなおや	梅田直哉	固有一般
うめだりく	梅田陸空	固有一般
うめつだにえる	梅津ダニエル	固有一般
うめつれお	梅津怜央	固有一般
うめずかつき	梅津克貴	固有一般
うめないかずま	梅内和磨	固有一般
うめはらかける	梅原翔琉	固有一般
うめばちたかひで	梅鉢貴秀	固有一般
うめむらはるき	梅村晴貴	固有一般
うめやまおさむ	梅山修	固有一般
うらじゅうぞう	浦十藏	固有一般
うらひろし	浦紘史	固有一般
うらかみたけし	浦上壮史	固有一般
うらかみにき	浦上仁騎	固有一般
うらかわともき	浦川友希	固有一般
うらしまたかひろ	浦島貴大	固有一般
うらたいつき	浦田樹	固有一般
うらたなおき	浦田尚希	固有一般
うらたのぶひさ	浦田延尚	固有一般
うらべたろう	卜部太郎	固有一般
うらべてんじゅ	占部天寿	固有一般
うらもとけんたろう	浦本賢太郎	固有一般
うりゅうこせい	瓜生昂勢	固有一般
うるしだてけんた	漆舘拳大	固有一般
うるのじゅん	宇留野純	固有一般
たかぎけいん	高木 ケイン	固有一般
えいながたかとら	永長鷹虎	固有一般
えがしらかずき	江頭一輝	固有一般
えがみりゅうた	江上竜汰	固有一般
えがわげんき	江川慶城	固有一般
えがわしげみつ	江川重光	固有一般
えがわゆうせい	江川湧清	固有一般
えぐちたくま	江口拓真	固有一般
えぐちともじ	江口倫司	固有一般
えぐちなお	江口直生	固有一般
えぐちりょうま	江口稜馬	固有一般
えごけんいち	江後賢一	固有一般
えさかあたる	江坂任	固有一般
えさきかずひと	江﨑一仁	固有一般
えざきたくろう	江﨑巧朗	固有一般
えじりあつひこ	江尻篤彦	固有一般
えすくでろせるひお	エスクデロ 競飛王	固有一般
えすみけんた	江角健太	固有一般
えずみこうじ	江角浩司	固有一般
えぞえけんじろう	江添建次郎	固有一般
えだひろし	江田広	固有一般
えだむらたくま	枝村匠馬	固有一般
えだもとゆういちろう	枝本雄一郎	固有一般
えちごかずお	越後和男	固有一般
えとうまさし	江藤将司	固有一般
えとうみきや	衛藤幹弥	固有一般
えとうゆう	衛藤裕	固有一般
えのもといつき	榎本樹	固有一般
えのもとけいご	榎本啓吾	固有一般
えのもとこうだい	榎本滉大	固有一般
えのもとじゅん	榎本潤	固有一般
えのもとたつや	榎本達也	固有一般
えのもとだいき	榎本大輝	固有一般
えのもとてつや	榎本哲也	固有一般
えはらえいじ	江原叡志	固有一般
えばしゆうと	江橋勇斗	固有一般
えばたしゅんすけ	江幡俊介	固有一般
えるしゃたーぶぶらいとかい	エルシャターブブライト海	固有一般
えんどうあきひろ	遠藤彰弘	固有一般
えんどうけいすけ	遠藤敬佑	固有一般
えんどうけいた	遠藤渓太	固有一般
えんどうげんいち	遠藤元一	固有一般
えんどうさいた	遠藤才大	固有一般
えんどうじゅんき	遠藤純輝	固有一般
えんどうたいし	遠藤大志	固有一般
えんどうたかひろ	遠藤孝弘	固有一般
えんどうひかる	遠藤光	固有一般
えんどうまさき	遠藤雅己	固有一般
えんどうまさひろ	遠藤昌浩	固有一般
えんどうまさよし	圓道将良	固有一般
えんどうやすし	遠藤康	固有一般
えんどうやすひと	遠藤保仁	固有一般
えんどうりょう	遠藤凌	固有一般
えんどうわたる	遠藤航	固有一般
おじゃんえん	呉章銀	固有一般
おいじけいた	生地慶多	固有一般
おいじたいよう	生地太陽	固有一般
おいじよしあつ	生地慶充	固有一般
おいずみだいき	尾泉大樹	固有一般
おいでふみや	大出文哉	固有一般
わんしんう	王新宇	固有一般
おうぎはらたかひろ	扇原貴宏	固有一般
おだまこと	網田慎	固有一般
おおいけんたろう	大井健太郎	固有一般
おおいしあすき	大石明日希	固有一般
おおいしあつと	大石篤人	固有一般
おおいしけんた	大石健太	固有一般
おおいしさとし	大石悟司	固有一般
おおいしたかお	大石隆夫	固有一般
おおいしたかや	大石尚哉	固有一般
おおいしだん	大石暖	固有一般
おおいしつぐとし	大石治寿	固有一般
おおいしてつや	大石鉄也	固有一般
おおいしのぶゆき	大石信幸	固有一般
おおいしふみや	大石文弥	固有一般
おおいしゆうすけ	大石悠介	固有一般
おおいしりゅうへい	大石竜平	固有一般
おおいしりょう	大石玲	固有一般
おおいずみかずや	大泉和也	固有一般
おおいわかずき	大岩一貴	固有一般
おおいわごう	大岩剛	固有一般
おおいわてっぺい	大岩徹平	固有一般
おおいわりょうた	大岩亮太	固有一般
おおうちいっせい	大内一生	固有一般
おおえゆうじ	大江勇詞	固有一般
おおえのきかつみ	大榎克己	固有一般
おおかわけい	大川圭為	固有一般
おおがきゆうき	大垣勇樹	固有一般
おおがみともあき	大神友明	固有一般
おがわらゆうと	大河原優斗	固有一般
おおきさとる	大木暁	固有一般
おおきすすむ	大木勉	固有一般
おおくぼごうし	大久保剛志	固有一般
おおくぼたかひろ	大久保貴広	固有一般
おおくぼたくお	大久保択生	固有一般
おおくぼたつと	大久保龍人	固有一般
おおくぼてつや	大久保哲哉	固有一般
おおくぼともあき	大久保智明	固有一般
おおくぼまこと	大久保誠	固有一般
おおくぼゆう	大久保優	固有一般
おおくぼゆうき	大久保祐希	固有一般
おおくぼゆうき	大久保裕樹	固有一般
おおくぼよしと	大久保嘉人	固有一般
おおくまけんた	大熊健太	固有一般
おおくまゆうじ	大熊裕司	固有一般
おおくらさとし	大倉智	固有一般
おおくらまぁしゅん	大倉舞駿	固有一般
おおぐししょうへい	大串昇平	固有一般
おおぐろまさし	大黒将志	固有一般
おおごしひろと	大越寛人	固有一般
おおさかあやと	逢坂文都	固有一般
おおさかひろと	逢坂大翔	固有一般
おおさきこうし	大崎航詩	固有一般
おおさきしゅん	大崎舜	固有一般
おおさきじゅんや	大﨑淳矢	固有一般
おおさきれお	大﨑玲央	固有一般
おおさこあおと	大迫蒼人	固有一般
おおさこあきら	大迫暁	固有一般
おおさこけいすけ	大迫敬介	固有一般
おおさこのぞみ	大迫希	固有一般
おおさこゆうや	大迫勇也	固有一般
おおさこよしあき	大迫義明	固有一般
おおさこるい	大迫塁	固有一般
おさとこうま	大里皇馬	固有一般
おおさわうのん	大澤羽隠	固有一般
おおさわげんい	大澤元栄	固有一般
おおさわしゅんた	大澤俊太	固有一般
おおさわともや	大澤朋也	固有一般
おおさわともや	大沢朋也	固有一般
おおさわゆうき	大澤雄樹	固有一般
おしばかつとも	大柴克友	固有一般
おしばけんじ	大柴健二	固有一般
おしまこうき	大島康樹	固有一般
おしまたかし	大嶌貴	固有一般
おしまたかひろ	大島嵩弘	固有一般
おしまつばさ	大島翼	固有一般
おしまはるき	大嶋春樹	固有一般
おしまひでお	大島秀夫	固有一般
おしまやすあき	大島康明	固有一般
おしまりょうた	大島僚太	固有一般
おおしろけい	大城 蛍	固有一般
おおしろゆうと	大城佑斗	固有一般
おおすぎさとし	大杉啓	固有一般
おおすぎまさと	大杉誠人	固有一般
おおぜきけんと	大関健斗	固有一般
おおぜきゆうと	大関友翔	固有一般
おおそねこうた	大曽根広汰	固有一般
おおたかずき	太田一輝	固有一般
おおたがくじ	太田岳志	固有一般
おおたけいすけ	太田圭輔	固有一般
おおたけいすけ	太田恵介	固有一般
おおたけんご	太田賢吾	固有一般
おおたこうすけ	太田宏介	固有一般
おおたこうすけ	太田康介	固有一般
おおたしゅうすけ	太田修介	固有一般
おおたしゅんすけ	大田隼輔	固有一般
おおたそま	大田湊真	固有一般
おおたたかみつ	太田貴光	固有一般
おおたてつろう	太田徹郎	固有一般
おおたなるみ	太田成美	固有一般
おおたはると	太田陽斗	固有一般
おおたひろかず	太田裕和	固有一般
おおたまさひろ	太田昌宏	固有一般
おおたまさゆき	太田雅之	固有一般
おおたよしあき	太田吉彰	固有一般
おおたりゅうのすけ	太田龍之介	固有一般
おおたわたる	太田渉	固有一般
おおたけしょうご	大竹将吾	固有一般
おおたけたくま	大嶽拓馬	固有一般
おおたけなおと	大嶽直人	固有一般
おおたけまさと	大嶽真人	固有一般
おおたけゆうしん	大竹優心	固有一般
おおたけゆうせい	大竹悠聖	固有一般
おおたけようへい	大竹洋平	固有一般
おおたけりゅうと	大竹隆人	固有一般
おおたにけいし	大谷圭志	固有一般
おおたにこうき	大谷幸輝	固有一般
おおたにたけひろ	大谷武大	固有一般
おおたになおき	大谷尚輝	固有一般
おおたにはやと	大谷駿斗	固有一般
おおたにひでかず	大谷秀和	固有一般
おおたにまさし	大谷真史	固有一般
おおたにまさし	大谷昌司	固有一般
おおつひびき	大津響輝	固有一般
おおつゆうき	大津祐樹	固有一般
おおつゆうわ	大津佑和	固有一般
おおつようせい	大津耀誠	固有一般
おおつかかずゆき	大塚和征	固有一般
おおつかしょう	大塚翔	固有一般
おおつかしょうた	大塚翔太	固有一般
おおつかしょうへい	大塚翔平	固有一般
おおつかしんじ	大塚真司	固有一般
おおつかたくみ	大塚拓海	固有一般
おおつかひろと	大塚尋斗	固有一般
おおつきしゅうへい	大槻周平	固有一般
おおつきともや	大槻智也	固有一般
おおつきひろし	大槻紘士	固有一般
おおつきゆうへい	大槻優平	固有一般
おおつぼとい	大坪十維	固有一般
おおつぼひろかず	大坪博和	固有一般
おおともさとし	大友慧	固有一般
おおともちひろ	大友千裕	固有一般
おおともゆうや	大友侑也	固有一般
おおともりゅうすけ	大友竜輔	固有一般
おおにしこうじ	大西孝治	固有一般
おおにししょうご	大西勝俉	固有一般
おおにししょうや	大西翔也	固有一般
おおにしたかし	大西貴	固有一般
おおにしたくま	大西拓真	固有一般
おおにしまさや	大西聖哉	固有一般
おおにしまさゆき	大西昌之	固有一般
おおにしゆうき	大西勇輝	固有一般
おおにしようへい	大西容平	固有一般
おおにしりょうたろう	大西遼太郎	固有一般
おおのかける	大野海翔	固有一般
おおのかずなり	大野和成	固有一般
おおのけいすけ	大野敬介	固有一般
おおのこうしょう	大野晃政	固有一般
おおのこうへい	大野耕平	固有一般
おおのしゅうと	大野秀和	固有一般
おおのしゅんぞう	大野俊三	固有一般
おおのしんり	大野榛里	固有一般
おおのちょるふぁん	大野哲煥	固有一般
おおのつよし	大野剛	固有一般
おおのはるたか	大野敏隆	固有一般
おおのゆうや	大野佑哉	固有一般
おおのようへい	大野耀平	固有一般
おおのよしふみ	大野貴史	固有一般
おおはしあきよし	大橋昭好	固有一般
おおはしこうた	大橋滉太	固有一般
おおはしひさし	大橋尚志	固有一般
おおはしまさひろ	大橋正博	固有一般
おおはしもとふみ	大橋基史	固有一般
おおはしゆうき	大橋祐紀	固有一般
おおはしよしたか	大橋良隆	固有一般
おおはたあゆむ	大畑歩夢	固有一般
おおはたたくや	大畑拓也	固有一般
おおはたりゅうや	大畑隆也	固有一般
おおはらしょうき	大原彰輝	固有一般
おおはらたくひろ	大原卓丈	固有一般
おおはらゆうたろう	大原悠太朗	固有一般
おおばあきら	大場啓	固有一般
おおばけんじ	大場健史	固有一般
おおばりゅうせい	大峡龍聖	固有一般
おおひらたくみ	大平卓海	固有一般
おおぶしゅん	大武峻	固有一般
おおぶちらいじゅ	大渕来珠	固有一般
おおほりりょうのすけ	大堀亮之介	固有一般
おおまえげんき	大前元紀	固有一般
おおまちしょうご	大町将梧	固有一般
おおみちひろゆき	大道広幸	固有一般
おおみなみたくま	大南拓磨	固有一般
おおむらこうすけ	大村康輔	固有一般
おおもとただてる	大本忠輝	固有一般
おおもとともや	大本智也	固有一般
おおもとゆうき	大本祐槻	固有一般
おおももかいと	大桃海斗	固有一般
おおももれおん	大桃怜音	固有一般
おおもりけんさく	大森健作	固有一般
おおもりこうたろう	大森晃太郎	固有一般
おおもりしょう	大森渚生	固有一般
おおもりしんご	大森真吾	固有一般
おおもりだいち	大森大地	固有一般
おおもりひろき	大森啓生	固有一般
おおもりひろし	大森博	固有一般
おおもりまさゆき	大森征之	固有一般
おおもりりお	大森理生	固有一般
おおもりりょう	大森涼	固有一般
おおやつばさ	大屋翼	固有一般
おおやまきょうへい	大山恭平	固有一般
おおやまけいすけ	大山啓輔	固有一般
おおやまこうせい	大山晃生	固有一般
おおやましゅんすけ	大山俊輔	固有一般
おおやませいな	大山晟那	固有一般
おおやまなおひろ	大山直大	固有一般
おおやまむさし	大山武蔵	固有一般
おおわだまさし	大和田真史	固有一般
おかてっぺい	岡哲平	固有一般
おかひでき	岡英輝	固有一般
おかひろき	岡大生	固有一般
おかよしき	岡佳樹	固有一般
おかざきかずや	岡﨑 和也	固有一般
おかざきけんや	岡﨑 建哉	固有一般
おかざきしんじ	岡崎慎司	固有一般
おかざきとらたろう	岡崎寅太郎	固有一般
おかざきまこと	岡崎慎	固有一般
おかざきりょうへい	岡﨑亮平	固有一般
おかざわこうせい	岡澤昂星	固有一般
おかじまきよのぶ	岡島清延	固有一般
おかだあおい	岡田蒼生	固有一般
おかだあきひさ	岡田明久	固有一般
おかだしゅ	岡田珠羽	固有一般
おかだしょうへい	岡田翔平	固有一般
おかだしんじ	岡田慎司	固有一般
おかだたける	岡田武瑠	固有一般
おかだだい	岡田大	固有一般
おかだつばさ	岡田翼	固有一般
おかだなおひこ	岡田直彦	固有一般
おかだやまと	岡田大和	固有一般
おかだゆうき	岡田優希	固有一般
おかだゆうき	岡田佑樹	固有一般
おかだゆうせい	岡田祐政	固有一般
おかだりゅう	岡田隆	固有一般
おかだりゅうじ	岡田竜二	固有一般
おかだりょうた	岡田亮太	固有一般
おかなかはやと	岡中勇人	固有一般
おかにしこうすけ	岡西宏祐	固有一般
おかにわしゅうと	岡庭愁人	固有一般
おかにわゆうき	岡庭裕貴	固有一般
おかねなおや	岡根直哉	固有一般
おかのしゅうた	岡野周太	固有一般
おかのじゅん	岡野洵	固有一般
おかのまさゆき	岡野雅行	固有一般
おかのりんぺい	岡野凜平	固有一般
おかべせな	岡部聖南	固有一般
おかむらかずや	岡村和哉	固有一般
おかむらしゅうや	岡村修哉	固有一般
おかむらだいはち	岡村大八	固有一般
おかむらよしき	岡村宜城	固有一般
おかもとかずま	岡本一真	固有一般
おかもとがく	岡本岳	固有一般
おかもとこうじ	岡本浩司	固有一般
おかもとこたろう	岡本虎太郎	固有一般
おかもとしょうせい	岡本將成	固有一般
おかもとそうた	岡本壮太	固有一般
おかもとたいよう	岡本泰陽	固有一般
おかもとたくや	岡本拓也	固有一般
おかもとたけし	岡本剛史	固有一般
おかもとたつや	岡本達也	固有一般
おかもとだいち	岡本大知	固有一般
おかもとだいな	岡本大和	固有一般
おかもとともたか	岡本知剛	固有一般
おかもとはやと	岡元勇人	固有一般
おかもとひでや	岡本英也	固有一般
おかもとまさいろ	岡本昌弘	固有一般
おかもとみちや	岡本享也	固有一般
おかもとやすあき	岡本賢明	固有一般
おかもとゆうき	岡本勇輝	固有一般
おかもとりく	岡本陸	固有一般
おかもとりゅうご	岡本隆吾	固有一般
おかもとりゅうのすけ	岡本竜之介	固有一般
おかやまかずき	岡山和輝	固有一般
おかやまかずなり	岡山一成	固有一般
おかやまてつや	岡山哲也	固有一般
おがさわらけいすけ	小笠原佳祐	固有一般
おがさわらけんせい	小笠原賢聖	固有一般
おがさわらみつお	小笠原満男	固有一般
おがさわらゆうせい	小笠原侑生	固有一般
おがしわつよし	小柏剛	固有一般
おがわえんはる	小川エンハル	固有一般
おがわかいせい	小川開世	固有一般
おがわけいじろう	小川慶治朗	固有一般
おがわこうき	小川航基	固有一般
おがわしほ	小河詩朋	固有一般
おがわじょう	尾川丈	固有一般
おがわせいいち	小川誠一	固有一般
おがわせな	小川聖凪	固有一般
おがわそら	小川大空	固有一般
おがわたくみ	小川巧	固有一般
おがわたつや	小川達也	固有一般
おがわだいき	小川大貴	固有一般
おがわなおき	小川直毅	固有一般
おがわひかり	小川創煌	固有一般
おがわひろき	小川紘生	固有一般
おがわまさき	小川雅己	固有一般
おがわまさき	小川真輝	固有一般
おがわゆうすけ	小川優介	固有一般
おがわゆうだい	小川雄大	固有一般
おがわよしずみ	小川佳純	固有一般
おがわりょうや	小川諒也	固有一般
おがわりん	小川麟	固有一般
おきかいと	起海斗	固有一般
おきゆうや	沖悠哉	固有一般
おきざきはやて	沖崎颯	固有一般
おきつだいぞう	興津大三	固有一般
おきのまさき	沖野将基	固有一般
おぎこうた	荻晃太	固有一般
おぎそはるき	小木曽春樹	固有一般
おぎのこうた	荻野広大	固有一般
おぎのもとのぶ	荻野元伸	固有一般
おぎはらけいた	荻原渓太	固有一般
おぎわらたくや	荻原拓也	固有一般
おくだいすけ	奥大介	固有一般
おくいひろき	奥井大貴	固有一般
おくいりょう	奥井諒	固有一般
おくがわまさや	奥川雅也	固有一般
おくだこうや	奥田晃也	固有一般
おくだたつろう	奥田達朗	固有一般
おくだだいじろう	奥田大二郎	固有一般
おくだはやと	奥田勇斗	固有一般
おくだひろき	奥田裕貴	固有一般
おくだゆうだい	奥田雄大	固有一般
おくつれいた	奥津玲太	固有一般
おくぬきかんじ	奥抜侃志	固有一般
おくのこうへい	奥野耕平	固有一般
おくのしんたろう	奥野慎太郎	固有一般
おくのせいいちろう	奥野誠一郎	固有一般
おくのひろあき	奥埜博亮	固有一般
おくのまさあき	奥野雅晶	固有一般
おくのりょうすけ	奥野僚右	固有一般
おくはらたかし	奥原崇	固有一般
おくみやだいち	屋宮大地	固有一般
おくむらこうじ	奥村晃司	固有一般
おくむらじん	奥村仁	固有一般
おくむらみき	奥村海生	固有一般
おくむらよしゆき	奥村慶之	固有一般
おくもとたいせい	奥元大晴	固有一般
おくやまたくろう	奥山卓廊	固有一般
おくやままさゆき	奥山政幸	固有一般
おくやまやすひろ	奥山泰裕	固有一般
おくやまようへい	奥山洋平	固有一般
おくやまりく	奥山璃空	固有一般
おぐらかいせい	小椋凱生	固有一般
おぐらしょうへい	小椋祥平	固有一般
おぐらたかふみ	小倉隆史	固有一般
おぐらてつや	小椋哲也	固有一般
おぐらひなた	小倉陽太	固有一般
おぐばぐしょうせい	オグヴァーグ翔星	固有一般
おさだみちやす	長田道泰	固有一般
おさだりょうへい	長田涼平	固有一般
おさないたかや	小山内貴哉	固有一般
おざきえいいちろう	尾崎瑛一郎	固有一般
おざきかずお	尾崎加寿夫	固有一般
おざきゆうし	尾﨑勇史	固有一般
おざきゆうじ	尾崎雄二	固有一般
おざきゆうせい	尾崎優成	固有一般
おざわあきひと	小澤章人	固有一般
おざわしゅうたろう	小澤秀太郎	固有一般
おざわしゅんすけ	小澤俊介	固有一般
おざわたくみ	小澤巧	固有一般
おざわつかさ	小澤司	固有一般
おざわはるき	小澤晴樹	固有一般
おざわひかる	小澤光	固有一般
おざわひであき	小澤英明	固有一般
おざわひであつ	小澤秀充	固有一般
おざわゆうき	小澤雄希	固有一般
おしくぼしおん	押久保汐音	固有一般
おしだにゆうき	押谷祐樹	固有一般
おしとみたいき	押富大輝	固有一般
おじまとおる	小島徹	固有一般
おじまみずき	小島瑞來	固有一般
おぜきようせい	小関陽星	固有一般
おたぎりみちはる	小田切道治	固有一般
おだいつき	小田逸稀	固有一般
おだそう	小田奏	固有一般
おだゆうたろう	小田裕太郎	固有一般
おだがきこうき	小田垣皓己	固有一般
おだがきめぐる	小田垣旋	固有一般
おだじまたかゆき	小田島隆幸	固有一般
おだじまりょう	小田島怜	固有一般
おだじまれい	小田島怜	固有一般
おちはやと	越智隼人	固有一般
おちりょうすけ	越智亮介	固有一般
おちあいたけと	落合毅人	固有一般
おちあいまさゆき	落合正幸	固有一般
おちあいりく	落合陸	固有一般
おちいずみしょうま	音泉翔眞	固有一般
おないうあど	オナイウ阿道	固有一般
おないうげおじ	オナイウ情滋	固有一般
おながひじり	翁長聖	固有一般
おにきとおる	鬼木達	固有一般
おにきはやと	鬼木颯都	固有一般
おにづかてんむ	鬼塚天夢	固有一般
おぬまあきと	小沼昭人	固有一般
おぬまたつき	小沼樹輝	固有一般
おのあきみち	小野耀路	固有一般
おのけいすけ	小野敬輔	固有一般
おのこうた	小野広太	固有一般
おのしゅんすけ	小野俊輔	固有一般
おのしんぎ	小野信義	固有一般
おのしんじ	小野伸二	固有一般
おのたかよし	小野隆儀	固有一般
おのともよし	小野智吉	固有一般
おのなるむ	小野成夢	固有一般
おのひろのぶ	小野博信	固有一般
おのまさひと	小野雅史	固有一般
おのゆうじ	小野裕二	固有一般
おのゆうと	小野悠斗	固有一般
おのゆうへい	小野雄平	固有一般
おのりょうや	小野凌也	固有一般
おのえしげお	尾上恵生	固有一般
おのえゆうせい	尾上瑠聖	固有一般
おのえゆうや	尾上勇也	固有一般
おのざわとしき	斧澤隼輝	固有一般
おのせこうすけ	小野瀬康介	固有一般
おのぜきとらのすけ	小野関虎之介	固有一般
おのだまさひと	小野田将人	固有一般
おのでらけんと	小野寺建人	固有一般
おのでらけんや	小野寺健也	固有一般
おのでらたくみ	小野寺巧	固有一般
おのでらたつや	小野寺達也	固有一般
おのでられん	小野寺蓮	固有一般
おのはらかずや	小野原和哉	固有一般
おはらもとき	小原基樹	固有一般
おばたえいしょう	小幡瑛成	固有一般
おばたじゅんぺい	小幡純平	固有一般
おぬまゆうま	小畑裕馬	固有一般
おばたけてんと	小畠伝人	固有一般
おびらんでぃーえめか	小枇ランディーエメカ	固有一般
おぼなやろみお	オボナヤ朗充於	固有一般
おまたひろゆき	尾亦弘友希	固有一般
おみけいご	小見恵吾	固有一般
おみとしや	尾身俊哉	固有一般
おむらのりお	小村徳男	固有一般
おむらわたる	尾村航	固有一般
おもてはらげんた	表原玄太	固有一般
おもとけい	尾本敬	固有一般
おもやゆくと	面矢行斗	固有一般
おりぐちてるき	折口輝樹	固有一般
じゃしゅうぜん	賈秀全	固有一般
かいけんたろう	甲斐健太郎	固有一般
かいてつし	甲斐鉄士	固有一般
かいもとけいじ	海本慶治	固有一般
かいもとけいたろう	海本慶太朗	固有一般
かいもとこうじろう	海本幸治郎	固有一般
かえつひであき	嘉悦秀明	固有一般
かがけんいち	加賀健一	固有一般
かがみけんすけ	加賀見健介	固有一般
かがみしょう	加賀美翔	固有一般
かがみとい	加々美登生	固有一般
かがわしんじ	香川真司	固有一般
かがわみきや	香川幹弥	固有一般
かがわゆうき	香川勇気	固有一般
かきうちしょうた	垣内祥大	固有一般
かきうちゆうじ	垣内友二	固有一般
かきぎりょうすけ	柿木亮介	固有一般
かきたゆうき	垣田裕暉	固有一般
かきたによういちろう	柿谷曜一朗	固有一般
かきねたくや	垣根拓也	固有一般
かきもとけんた	柿本健太	固有一般
かきもとしょうた	柿本聖太	固有一般
かきもとみちあき	柿本倫明	固有一般
かぎやまけいじ	鍵山慶司	固有一般
かくてひ	郭 泰輝	固有一般
かくたくんぺい	角田薫平	固有一般
かくだまこと	角田誠	固有一般
かくらいたくや	加倉井拓弥	固有一般
かけがわまこと	掛川誠	固有一般
かけひゆう	懸樋優	固有一般
かげやまけんじ	景山健司	固有一般
かげやまけんぞう	影山兼三	固有一般
かげやまこうた	影山倖大	固有一般
かげやまたかし	影山貴志	固有一般
かげやままさなが	影山雅永	固有一般
かげやまよしたか	影山由高	固有一般
かげやまるいと	影山塁飛	固有一般
かこいけんたろう	圍謙太朗	固有一般
かさがわえいた	笠川永太	固有一般
かさぎゆず	笠木優寿	固有一般
かさはらすなお	笠原淳	固有一般
かさはらそうた	笠原宗太	固有一般
かさはらたかし	笠原昂史	固有一般
かさはらりょうや	笠原綾也	固有一般
かさやなぎつばさ	笠柳翼	固有一般
かざまこうき	風間宏希	固有一般
かざまこうや	風間宏矢	固有一般
かざまやひろ	風間八宏	固有一般
かざわひゆ	賀澤陽友	固有一般
かしざきけいた	樫崎桂太	固有一般
かしはらゆうせい	栢原悠聖	固有一般
かしわよしふみ	柏好文	固有一般
かしわぎひいろ	柏木陽良	固有一般
かしわぎようすけ	柏木陽介	固有一般
かしわせさとる	柏瀬暁	固有一般
かじりょう	加地亮	固有一般
かじいかつし	梶居勝志	固有一般
かじうらゆうき	梶浦勇輝	固有一般
かじかわゆうじ	梶川裕嗣	固有一般
かじかわりょうた	梶川諒太	固有一般
かじのさとし	梶野智	固有一般
かじのともゆき	梶野智幸	固有一般
かじはらけいた	梶原啓太	固有一般
かじはらはると	梶原陽翔	固有一般
かじやまさひと	梶谷政仁	固有一般
かじやまかんた	梶山幹太	固有一般
かじやまよういち	梶山洋一	固有一般
かじやまようへい	梶山陽平	固有一般
かじわらけいた	梶原慧汰	固有一般
かじわらゆうきや	梶原夕希也	固有一般
かずままさひろ	數馬正浩	固有一般
かせなおき	加瀬直輝	固有一般
かたいたくみ	片井巧	固有一般
かたおかこうじ	片岡功二	固有一般
かたおかそう	片岡爽	固有一般
かたおかつばさ	片岡翼	固有一般
かたおかようすけ	片岡洋介	固有一般
かたがみたいそん	片上泰尊	固有一般
かたぎやすき	片木泰希	固有一般
かたぎりあつし	片桐淳至	固有一般
かたくらせいや	片倉誠也	固有一般
かたのひろみち	片野寛理	固有一般
かたのさかともひろ	片野坂知宏	固有一般
かたびらともゆき	帷智行	固有一般
かたふちこういちろう	片渕浩一郎	固有一般
かたやまえいいち	片山瑛一	固有一般
かたやましょうすけ	片山奨典	固有一般
かたやまひろと	片山寛人	固有一般
かたやままさと	片山真人	固有一般
かだじゅんや	加田淳哉	固有一般
かつきしょうや	勝木翔也	固有一般
かつべひなた	勝部陽太	固有一般
かつまたよしのり	勝又慶典	固有一般
かつやとしひさ	勝矢寿延	固有一般
かつらひでき	桂秀樹	固有一般
かつらりくと	桂陸人	固有一般
かとういっせい	加藤壱盛	固有一般
かとうけんと	加藤健人	固有一般
かとうげん	加藤玄	固有一般
かとうこうけん	加藤弘堅	固有一般
かとうこうへい	加藤恒平	固有一般
かとうしんたろう	加藤慎太郎	固有一般
かとうしんや	加藤慎也	固有一般
かとうじゅんや	加藤潤也	固有一般
かとうたいき	加藤大樹	固有一般
かとうたいち	加藤大智	固有一般
かとうたかとら	加藤嵩寅	固有一般
かとうたくと	加藤匠人	固有一般
かとうたくみ	加藤拓己	固有一般
かとうたけひろ	加藤豪宏	固有一般
かとうだいき	加藤大喜	固有一般
かとうだいし	加藤大志	固有一般
かとうだいすけ	加藤大育	固有一般
かとうだいや	加藤大也	固有一般
かとうちはる	加藤智陽	固有一般
かとうちひろ	加藤千尋	固有一般
かとうてつや	加藤徹也	固有一般
かとうとおる	加藤徹	固有一般
かとうとしかず	加藤寿一	固有一般
かとうとものしん	加藤友乃晋	固有一般
かとうのぞむ	加藤望	固有一般
かとうのぶひろ	加藤順大	固有一般
かとうひさし	加藤久	固有一般
かとうひじり	加藤聖	固有一般
かとうひでのり	加藤秀典	固有一般
かとうひろき	加藤広樹	固有一般
かとうまさる	加藤大	固有一般
かとうむつき	加藤陸次樹	固有一般
かとうやすあき	加藤泰明	固有一般
かとうゆうき	加藤有輝	固有一般
かとうゆうま	加藤悠馬	固有一般
かとうよしお	加藤好男	固有一般
かとうよしゆき	加藤善之	固有一般
かとうりゅうじ	加藤竜二	固有一般
かとうりょういち	加藤遼一	固有一般
かとうれん	加藤蓮	固有一般
かとうれんしょう	加藤蓮生	固有一般
かとりじゅん	香取潤	固有一般
かどぐちたいせい	角口大征	固有一般
かどのしょうた	角野翔汰	固有一般
かどわきはやと	門脇駿斗	固有一般
かないたかし	金井貢史	固有一般
かないりゅうた	金井隆太	固有一般
かないりょうた	金井亮太	固有一般
かながせじんと	金ヶ瀬仁人	固有一般
かなくぼさい	金久保彩	固有一般
かなくぼじゅん	金久保順	固有一般
かなぐちのぞむ	金口望	固有一般
かなざきむう	金崎夢生	固有一般
かなざわしん	金澤慎	固有一般
かなざわじょう	金沢浄	固有一般
かなざわたかふみ	金澤崇文	固有一般
かなざわひろまさ	金澤大将	固有一般
かなざわりょう	金沢亮	固有一般
かなぞのひでたか	金園英学	固有一般
かなもりけんじ	金森健志	固有一般
かなもりともや	金守智哉	固有一般
かなやまじゅんき	金山隼樹	固有一般
かにまさたか	可児壮隆	固有一般
かぬまなおき	鹿沼直生	固有一般
かねいだいき	金井大樹	固有一般
かねうらまさき	金浦真樹	固有一般
かねえだこうへい	金枝晃平	固有一般
かねこしょうた	金子翔太	固有一般
かねこせいじ	金古聖司	固有一般
かねこせいた	金子星太	固有一般
かねこそうた	金子颯太	固有一般
かねこたいせい	金子大晟	固有一般
かねこたくろう	金子拓郎	固有一般
かねこだいき	金子大毅	固有一般
かねこつよし	金子剛	固有一般
かねこひろき	金子弘樹	固有一般
かねこまこと	金子誠	固有一般
かねこまさひろ	金子昌広	固有一般
かねこゆうき	金子勇樹	固有一般
かねこゆうき	金子優希	固有一般
かねこゆたか	金子豊	固有一般
かねさかれいや	金坂励耶	固有一般
かねだあきしげ	兼田亜季重	固有一般
かねだあすか	金田飛鳥	固有一般
かねだやまと	金田大和	固有一般
かねもとけいた	金本圭太	固有一般
かねもとまさみつ	兼本正光	固有一般
かのかいせい	狩野海晟	固有一般
かのけんた	狩野健太	固有一般
かのうまさひろ	加納昌弘	固有一般
かのうれん	加納錬	固有一般
かのしまゆう	彼島優	固有一般
かばやまりょうのすけ	樺山諒乃介	固有一般
かぶらぎごう	鏑木豪	固有一般
かぶらぎみずき	鏑木瑞生	固有一般
かぶらぎとおる	鏑木享	固有一般
かぶらぎりょうご	鏑木亮吾	固有一般
かべみらん	加部未蘭	固有一般
かまたしょうま	鎌田翔雅	固有一般
かまたじろう	鎌田次郎	固有一般
かまたとらい	鎌田斗来	固有一般
かまだしょうへい	鎌田祥平	固有一般
かまだだいち	鎌田大地	固有一般
かまだひろむ	鎌田大夢	固有一般
かみおかともき	上岡朋樹	固有一般
かみかわたく	上川琢	固有一般
かみがきりく	神垣陸	固有一般
かみがしましゅうや	上ヶ嶋柊也	固有一般
かみがたようすけ	上形洋介	固有一般
かみささぬきまもる	上笹貫剣	固有一般
かみしまたくみ	上島拓巳	固有一般
かみじょうひろあき	上條宏晃	固有一般
かみぞのかずあき	上園和明	固有一般
かみたじゅん	嘉味田隼	固有一般
かみにししゅんぺい	上西峻平	固有一般
かみのりょうた	神野亮太	固有一般
かみひがしゆきと	上東悠樹斗	固有一般
かみふくもとなおと	上福元直人	固有一般
かみまるよいち	神丸洋一	固有一般
かみむらしゅうへい	上村周平	固有一般
かみむらしょう	神村奨	固有一般
かみむらねお	上村音生	固有一般
かみむらゆうじ	上村祐司	固有一般
かみもとひろと	紙元大翔	固有一般
かみやかいと	神谷凱士	固有一般
かみやしゅんや	神谷駿文	固有一般
かみやゆうすけ	神谷悠介	固有一般
かみやゆうた	神谷優太	固有一般
かみやりょうと	神谷椋士	固有一般
かみやまきょうすけ	神山京右	固有一般
かみやまりゅういち	神山竜一	固有一般
かめかわまさし	亀川諒史	固有一般
かめしましゅう	亀島周	固有一般
かめだこうき	亀田光貴	固有一般
かめだたいが	亀田大河	固有一般
かもつよし	加茂剛	固有一般
かもがわしょう	鴨川奨	固有一般
かもしだたかし	鴨志田誉	固有一般
かもはらたつや	蒲原達也	固有一般
かやぬまゆうせい	萱沼優聖	固有一般
からしまけいじゅ	辛島啓珠	固有一般
かりまいとわ	苅米飛和	固有一般
かりまたあきと	狩俣瑛斗	固有一般
かどなぜん	狩土名禅	固有一般
かるべりゅうたろう	苅部隆太郎	固有一般
かるべわたる	軽部倭太琉	固有一般
かわいあゆむ	川井歩	固有一般
かわいけんた	川井健太	固有一般
かわいこういち	川井光一	固有一般
かわいしゅうと	河合秀人	固有一般
かわいしゅん	河合駿	固有一般
かわいたかやす	河合崇泰	固有一般
かわいてつた	河井哲太	固有一般
かわいとくも	川合徳孟	固有一般
かわいひなた	川合陽	固有一般
かわいももたろう	川井桃太朗	固有一般
かわいようすけ	河井陽介	固有一般
かわいりゅうじ	河合竜二	固有一般
かわいだりょうや	川井田稜弥	固有一般
かわかつひろやす	川勝博康	固有一般
かわかみちえ	川上エドオジョン智慧	固有一般
かわかみこうき	川上航生	固有一般
かわかみこうへい	川上康平	固有一般
かわかみしゅん	川上隼	固有一般
かわかみしょうへい	河上将平	固有一般
かわかみしょうへい	川上翔平	固有一般
かわかみせいじ	川上盛司	固有一般
かわかみつばさ	川上翼	固有一般
かわかみのりひろ	川上典洋	固有一般
かわかみゆうき	川上優樹	固有一般
かわかみゆうと	川上悠斗	固有一般
かわかみよせい	川上陽星	固有一般
かわかみりゅう	川上竜	固有一般
かわきたゆうすけ	川北裕介	固有一般
かわぎしゆうすけ	川岸祐輔	固有一般
かわぐちあきら	川口晃	固有一般
かわぐちかずや	川口和也	固有一般
かわぐちこうへい	川口航平	固有一般
かわぐちしんいち	河口真一	固有一般
かわぐちそうすけ	川口蒼友	固有一般
かわぐちたくや	川口卓哉	固有一般
かわぐちなおき	川口尚紀	固有一般
かわぐちのぶお	川口信男	固有一般
かわぐちまさし	川口真史	固有一般
かわぐちまさと	川口正人	固有一般
かわぐちゆうま	川口佑真	固有一般
かわぐちよしかつ	川口能活	固有一般
かわさきあきひろ	川崎晶弘	固有一般
かわさきあつし	川﨑淳	固有一般
かわさきいっき	川﨑一輝	固有一般
かわさきけんたろう	川崎健太郎	固有一般
かわさきしゅうへい	川﨑修平	固有一般
かわさきそうた	川﨑 颯太	固有一般
かわさきもとき	川崎元気	固有一般
かわさきやすまさ	川﨑裕大	固有一般
かわさきらい	川崎楽生	固有一般
かわさとこうたろう	川里光太郎	固有一般
かわしまえいじ	川島永嗣	固有一般
かわしまこうき	川島康暉	固有一般
かわしましんや	川島眞也	固有一般
かわしまだいき	川島大輝	固有一般
かわしまだいち	川島大地	固有一般
かわしまとおる	川島透	固有一般
かわしまのぶゆき	川島將	固有一般
かわしまみざき	川島みざき	固有一般
かわたあつひで	河田篤秀	固有一般
かわたかずひろ	川田和宏	固有一般
かわたけんと	川田拳登	固有一般
かわたこうへい	河田晃兵	固有一般
かわたしゅうへい	川田修平	固有一般
かわたになぎ	川谷凪	固有一般
かわだなみひろ	河田波大	固有一般
かわだのぶしげ	川田信茂	固有一般
かわだりょうた	河田稜太	固有一般
かわづりょういち	河津良一	固有一般
かわずめんあきなり	河面旺成	固有一般
かわとだいき	川戸大樹	固有一般
かわなかけんた	川中健太	固有一般
かわなべたかや	川辺隆弥	固有一般
かわなべりょうすけ	川鍋良祐	固有一般
かわなみおうじ	河波櫻士	固有一般
かわなみごろう	川浪吾郎	固有一般
かわにししょうた	川西翔太	固有一般
かわにしまこと	河西真	固有一般
かわのかずまさ	河野和正	固有一般
かわのけんいち	河野健一	固有一般
かわのこうた	河野孝汰	固有一般
かわのしんいち	河野真一	固有一般
かわのたかし	河野貴志	固有一般
かわのひろき	河野広貴	固有一般
かわのりく	河野陸	固有一般
かわのりょうすけ	河野諒祐	固有一般
かわはらかずひさ	河原和寿	固有一般
かわはらしゅうごう	川原周剛	固有一般
かわはらそう	河原創	固有一般
かわはらたつや	川原達也	固有一般
かわはらなつき	川原那月	固有一般
かわはらはやと	川原颯斗	固有一般
かわはらひろむ	川原大夢	固有一般
かわはらづかたけし	河原塚毅	固有一般
かわばたかずや	河端和哉	固有一般
かわべしゅんたろう	河辺駿太郎	固有一般
かわべはやお	川辺駿	固有一般
かわべゆうき	川邊裕紀	固有一般
かわまえはると	川前陽斗	固有一般
かわまえりきや	川前力也	固有一般
かわまたけんご	川又堅碁	固有一般
かわまたしんいちろう	川俣慎一郎	固有一般
かわまたゆうだい	川又由大	固有一般
かわむらがくと	川村楽人	固有一般
かわむらけいと	河村慶人	固有一般
かわむらじゅんいち	川村淳一	固有一般
かわむらたかひろ	河村崇大	固有一般
かわむらたくみ	河村匠	固有一般
かわむらたくむ	川村拓夢	固有一般
かわむらはやと	河村颯人	固有一般
かわむらまいや	川村舞弥	固有一般
かわむらゆう	河村優	固有一般
かわむらるい	川村琉偉	固有一般
かわもとあきと	河本明人	固有一般
かわもとまさひで	川元正英	固有一般
かわもとみつひろ	河本充弘	固有一般
かわもとりょうじ	川本良二	固有一般
かわもとりよ	川本梨誉	固有一般
かわもりゆうま	川森有真	固有一般
かわらぎひびき	河原木響	固有一般
かわらじりょうた	河原地亮太	固有一般
かわらだゆう	川原田湧	固有一般
かんかずのり	菅和範	固有一般
かんそんほ	姜成浩	固有一般
かんひゅんす	姜鉉守	固有一般
かんひょいる	姜曉一	固有一般
かんざきだいすけ	神崎大輔	固有一般
かんざわあさい	虷沢旭飛	固有一般
かんだかつお	神田勝夫	固有一般
かんだしょうま	神田渉馬	固有一般
かんだしょうや	神田翔哉	固有一般
かんだふみゆき	神田文之	固有一般
かんだゆめみ	神田夢実	固有一般
かんのこうき	菅野紘希	固有一般
かんのしょうた	菅野将太	固有一般
かんのたけと	菅野翔斗	固有一般
かんのてつや	菅野哲也	固有一般
かんのまさあき	菅野将晃	固有一般
かんばやしごう	上林豪	固有一般
かんばやしたいせい	上林大誠	固有一般
かんべこうすけ	神戸康輔	固有一般
かんめらしゅうと	上米良柊人	固有一般
がなはかずき	我那覇和樹	固有一般
がやえいじ	賀谷英司	固有一般
きかわだけんじ	黄川田賢司	固有一般
じゅふぇん	鞠楓	固有一般
きくいゆうすけ	菊井悠介	固有一般
きくおかたくろう	菊岡拓朗	固有一般
きくがわはる	菊川晴	固有一般
きくたにあつし	菊谷篤資	固有一般
きくちかん	菊池完	固有一般
きくちかんた	菊地貫太	固有一般
きくちきせき	菊池季汐	固有一般
きくちけんた	菊地健太	固有一般
きくちこうすけ	菊地光将	固有一般
きくちしゅうた	菊地脩太	固有一般
きくちしゅうた	菊池柊太	固有一般
きくちしゅんすけ	菊地俊介	固有一般
きくちしょうた	菊池将太	固有一般
きくちしんきち	菊池新吉	固有一般
きくちたいち	菊地泰智	固有一般
きくちだいすけ	菊池大介	固有一般
きくちとしみ	菊池利三	固有一般
きくちなおや	菊地直哉	固有一般
きくちりくと	菊池陸斗	固有一般
きくちりゅうほ	菊池流帆	固有一般
きくのたいき	菊野太紀	固有一般
きくはらしろう	菊原志郎	固有一般
きくもとゆうき	菊本侑希	固有一般
きざわまさのり	木澤正徳	固有一般
きしかんた	岸寛大	固有一般
きしたかひで	紀氏隆秀	固有一般
きしだかずひと	岸田和人	固有一般
きしだしょうへい	岸田翔平	固有一般
きしだひろき	岸田裕樹	固有一般
きしだゆうすけ	岸田悠佑	固有一般
きしもとたける	岸本武流	固有一般
きしもとのぞむ	岸本望	固有一般
きじまかずき	鬼島和希	固有一般
きじまてつや	木島徹也	固有一般
きじまゆう	木島悠	固有一般
きじまりょうすけ	木島良輔	固有一般
きたかずなり	喜多壱也	固有一般
きたかずま	北一真	固有一般
きたやすし	喜多靖	固有一般
きたりょうすけ	喜多涼介	固有一般
きたりょうま	北龍磨	固有一般
きたいゆうき	北井佑季	固有一般
きたうちこうせい	北内耕成	固有一般
きたおくれん	北奥蓮	固有一般
きたがわこうへい	北川滉平	固有一般
きたがわこうや	北川航也	固有一般
きたがわしゅうと	北川柊斗	固有一般
きたがわよしお	北川佳男	固有一般
きたざとだいち	北里大地	固有一般
きたざわげんた	北澤元太	固有一般
きたざわつよし	北澤豪	固有一般
きたじまひであき	北嶋秀朗	固有一般
きたじまゆうじ	北島祐二	固有一般
きたじまよしき	北島義生	固有一般
きたたにふみたか	北谷史孝	固有一般
きたづめけんご	北爪健吾	固有一般
きたでつとむ	北出勉	固有一般
きたでなおひろ	北出尚大	固有一般
きたにこうすけ	木谷公亮	固有一般
きたのしょう	北野翔	固有一般
きたのそうた	北野颯太	固有一般
きたのたかゆき	北野貴之	固有一般
きたはしまさはる	北橋将治	固有一般
きたはまりゅうせい	北浜琉星	固有一般
きたはらいつき	北原一樹	固有一般
きたはらけんじ	北原健二	固有一般
きたはらたかひさ	北原毅之	固有一般
きたはらだいすけ	北原大奨	固有一般
きたむらかいちでぃ	北村海チディ	固有一般
きたむらくにお	北村邦夫	固有一般
きたむらたくや	北邑拓也	固有一般
きたむらともたか	北村知隆	固有一般
きたむらともや	北村知也	固有一般
きたむらふげつ	北村風月	固有一般
きたむらりゅうじ	北村隆二	固有一般
きたむらりょうた	北村椋太	固有一般
きたもとくにえ	北本久仁衛	固有一般
きたわきけんじ	北脇健慈	固有一般
きだたくや	喜田拓也	固有一般
きだひなた	喜田陽	固有一般
きだりょうが	貴田遼河	固有一般
きだりょうま	氣田亮真	固有一般
きちせひろし	吉瀬広志	固有一般
きついたかひろ	木匠貴大	固有一般
きでゆうと	木出雄斗	固有一般
きでらこういち	木寺浩一	固有一般
きとうりゅうと	紀藤隆翔	固有一般
きどこうき	木戸皓貴	固有一般
きどしゅうま	木戸柊摩	固有一般
きどくなおと	寄特直人	固有一般
きなてつひろ	喜名哲裕	固有一般
きのうちなお	木内直央	固有一般
きのしたあさひ	木下太陽	固有一般
きのしたかいと	木下海斗	固有一般
きのしたこうすけ	木下康介	固有一般
きのしたしんのすけ	木下慎之輔	固有一般
きのしたたかあき	木下高彰	固有一般
きのしたてっせい	木下哲星	固有一般
きのしたはる	木下晴陽	固有一般
きのしたまさき	木下正貴	固有一般
きのしたゆう	木下悠	固有一般
きのしたよしあき	木下淑晶	固有一般
きはらまさかず	木原正和	固有一般
きはられい	木原励	固有一般
きばまさお	木場昌雄	固有一般
きふじけんた	木藤健太	固有一般
きべみらん	木部未嵐	固有一般
きむうぃまん	金位漫	固有一般
きむえんじゅん	金殷中	固有一般
きむきす	金基洙	固有一般
きむくんほあん	金 根煥	固有一般
きむくゎんみん	金廣閔	固有一般
きむげんちょる	金根哲	固有一般
きむこんちょん	金功青	固有一般
きむさんう	金尚佑	固有一般
きむしんよん	金信泳	固有一般
きむじぇほ	金載桓	固有一般
きむじょんう	金 正友	固有一般
きむじょんひゅん	金正賢	固有一般
きむじょんぐん	金 鐘必	固有一般
きむじょんや	金正也	固有一般
きむじんきゅ	金珍圭	固有一般
きむじんす	金珍洙	固有一般
きむせうんよん	金 承龍	固有一般
きむそんぎ	金聖基	固有一般
きむそんすん	金成純	固有一般
きむそんみん	金誠敏	固有一般
きむすんみん	金善珉	固有一般
きむせんよん	金成勇	固有一般
きむちよるほ	金 喆鎬	固有一般
きむでい	金大儀	固有一般
きむどほん	金度勲	固有一般
きむどきゅん	金徒均	固有一般
きむどけうん	金 都根	固有一般
きむどんぐぉん	金東權	固有一般
きむどんちゃん	金東燦	固有一般
きむどんひょん	金東炫	固有一般
きむなむいる	金南一	固有一般
きむひょんすん	金炫成	固有一般
きむひゅんしょん	金賢聖	固有一般
きむほなむ	金浩男	固有一般
きむほんよん	金弘淵	固有一般
きむみんう	金民友	固有一般
きむみんほ	金珉浩	固有一般
きむみんきゅん	金民均	固有一般
きむゆじん	金裕晋	固有一般
きむよんぎ	金永基	固有一般
きむよんぐぉん	金 英權	固有一般
きむよんくん	金 永根	固有一般
きむよんふぁん	金竜滉	固有一般
きむらあつし	木村敦志	固有一般
きむらかいと	木村魁人	固有一般
きむらかずし	木村和司	固有一般
きむらけいん	木村恵允	固有一般
きむらごう	木村豪	固有一般
きむらしょうた	木村勝太	固有一般
きむらせいじ	木村誠二	固有一般
きむらせいめい	木村晟明	固有一般
きむらたかや	木村太哉	固有一般
きむらたくと	木村卓斗	固有一般
きむらたつろう	木村龍朗	固有一般
きむらてつまさ	木村哲昌	固有一般
きむらゆうき	木村裕貴	固有一般
きむらまこと	木村誠	固有一般
きむらまさひこ	木村允彦	固有一般
きむらゆう	木村裕	固有一般
きむらゆうじ	木村祐志	固有一般
きむらゆうだい	木村勇大	固有一般
きむらりょうや	木村凌也	固有一般
きもつきひろと	肝付啓人	固有一般
きもとあおと	木本蒼翔	固有一般
きもとけいすけ	木本敬介	固有一般
きもとたいが	木許太賀	固有一般
きもとやすき	木本恭生	固有一般
きやしだいすけ	樹森大介	固有一般
きやすこうせい	喜安康生	固有一般
きやまこうへい	喜山康平	固有一般
きやまそうすけ	木山創資	固有一般
きやまたかゆき	木山隆之	固有一般
きょうのゆうし	京野優士	固有一般
きょうやかずゆき	京谷和幸	固有一般
きよかわさすが	清川流石	固有一般
きよかわはる	清川遥	固有一般
きよたけこうき	清武功暉	固有一般
きよたけひろし	清武弘嗣	固有一般
きよながたける	清永丈瑠	固有一般
きよのおとひこ	清野乙彦	固有一般
きよはらしょうへい	清原翔平	固有一般
きよもとたくみ	清本拓己	固有一般
きりそうた	桐蒼太	固有一般
きりきつかさ	桐木士	固有一般
きりはたかずしげ	桐畑和繁	固有一般
きりやまりゅうと	桐山龍人	固有一般
きろーらんこりん	キローラン木鈴	固有一般
きろーらんにある	キローラン菜入	固有一般
きわだただし	木和田匡	固有一般
きんてるまさ	金晃正	固有一般
きむみょんひ	金明輝	固有一般
きんりょうや	金亮哉	固有一般
きんかわらいや	金川羅彌	固有一般
きんじょうあんどれたいき	金城アンドレ泰樹	固有一般
きんじょうくりすとふぁーたつき	金城クリストファー達樹	固有一般
きんじょうじゃすてぃんしゅんき	金城ジャスティン俊樹	固有一般
ぎぼゆきひで	儀保幸英	固有一般
ぎまりくと	儀間陸斗	固有一般
ぎょうとくえい	行徳瑛	固有一般
くきたしんご	久木田紳吾	固有一般
くきのさとし	久木野聡	固有一般
くぎさきやすおみ	釘﨑康臣	固有一般
くさかりけいた	草刈啓太	固有一般
くさかりなおだい	草苅脩大	固有一般
くさきかつひろ	草木克洋	固有一般
くさずみこうのすけ	草住晃之介	固有一般
くさのしゅうじ	草野修治	固有一般
くさのまなと	草野真人	固有一般
くさのゆうき	草野侑己	固有一般
くしだかずと	櫛田一斗	固有一般
くしのりょう	櫛野亮	固有一般
くしびきかずき	櫛引一紀	固有一般
くしびきまさとし	櫛引政敏	固有一般
くしびきみのる	櫛引実	固有一般
くすかみじゅんぺい	楠神順平	固有一般
くすのきだいき	楠大樹	固有一般
くすのせあきひと	楠瀬章仁	固有一般
くすみけいし	楠美圭史	固有一般
くすもとしゅうま	楠元秀真	固有一般
くすもとたくみ	楠本卓海	固有一般
くすもとつばさ	楠本羽翼	固有一般
くすもとゆきお	楠本幸雄	固有一般
くだかともお	久高友雄	固有一般
くつかけゆうた	沓掛勇太	固有一般
くつなきょうじ	忽那喬司	固有一般
くどうあおい	工藤蒼生	固有一般
くどうきよかず	久藤清一	固有一般
くどうこうた	工藤孝太	固有一般
くどうこうへい	工藤浩平	固有一般
くどうこうへい	工藤亘平	固有一般
くどうそうだい	工藤宗大	固有一般
くどうたいが	工藤大雅	固有一般
くどうまさと	工藤壮人	固有一般
くどうまなと	工藤真人	固有一般
くどうみつてる	工藤光輝	固有一般
くどうゆうせい	工藤祐生	固有一般
くどうゆむ	工藤由夢	固有一般
くどうりゅい	工藤瑠衣	固有一般
くにえだそら	國枝蒼空	固有一般
くにたけゆうと	國武勇斗	固有一般
くにひろしゅうへい	國廣周平	固有一般
くにもとたかひろ	邦本宜裕	固有一般
くにもとれお	国本玲央	固有一般
くによしたかひろ	國吉貴博	固有一般
くのじゅんや	久野純弥	固有一般
くのともあき	久野智昭	固有一般
くのりせいあ	久乗聖亜	固有一般
くばひかる	久場光	固有一般
くばまさとも	久場政朋	固有一般
くぼかいと	久保海都	固有一般
くぼせいいちろう	久保征一郎	固有一般
くぼせいじ	久保政二	固有一般
くぼたくみ	久保拓海	固有一般
くぼたけふさ	久保建英	固有一般
くぼたつひこ	久保竜彦	固有一般
くぼつばさ	久保飛翔	固有一般
くぼとうじろう	久保藤次郎	固有一般
くぼゆういち	久保裕一	固有一般
くぼゆうや	久保裕也	固有一般
くぼりき	久保力輝	固有一般
くぼりくと	久保吏久斗	固有一般
くぼしまたけはる	久保島健晴	固有一般
くぼたあきら	久保田陽	固有一般
くぼたかずね	久保田和音	固有一般
くぼたまなぶ	久保田学	固有一般
くぼたりゅうじ	窪田龍二	固有一般
くぼたりょう	窪田稜	固有一般
くぼたりょう	窪田良	固有一般
くぼたりんた	久保田琳太	固有一般
くぼにわりょうた	久保庭良太	固有一般
くぼやまよしきよ	久保山由清	固有一般
くまがいあんどりゅー	熊谷アンドリュー	固有一般
くまがいけいや	熊谷奎哉	固有一般
くまがいこうき	熊谷昂暉	固有一般
くまがいこうじ	熊谷浩二	固有一般
くまがいしゅうじ	熊谷柊治	固有一般
くまがいしゅん	熊谷駿	固有一般
くまがいたつや	熊谷達也	固有一般
くまがいまさひこ	熊谷雅彦	固有一般
くまがわかける	熊川翔	固有一般
くまくらたくみ	熊倉匠	固有一般
くまくらなるき	熊倉成希	固有一般
くまさかこうき	熊坂光希	固有一般
くますわかずき	熊澤和希	固有一般
くますわけいすけ	熊澤圭祐	固有一般
くまたなおき	熊田直紀	固有一般
くまばやししんご	熊林親吾	固有一般
くまもとゆうた	熊本雄太	固有一般
くめこうたろう	久米航太郎	固有一般
くめだせいあ	久米田聖海	固有一般
くもんひろあき	公文裕明	固有一般
くらおとむ	倉尾都夢	固有一般
くらかずひろと	倉員宏人	固有一般
くらかわようへい	藏川洋平	固有一般
くらたこうへい	蔵田岬平	固有一般
くらたしげき	藏田茂樹	固有一般
くらたしゅう	倉田秋	固有一般
くらたじゅら	倉田楠楽	固有一般
くらぬきかずき	倉貫一毅	固有一般
くらぬきらう	倉貫嵐羽	固有一般
くらみつとしき	蔵光利紀	固有一般
くらもとたかし	倉本崇史	固有一般
くりさわりょういち	栗澤僚一	固有一般
くりしたこはる	栗下心暖明	固有一般
くりしまけんた	栗島健太	固有一般
くりたしおん	栗田詩音	固有一般
くりたたいじろう	栗田泰次郎	固有一般
くりたまーくあじぇい	栗田マークアジェイ	固有一般
くりはらかつし	栗原克志	固有一般
くりはらけいすけ	栗原圭介	固有一般
くりはらしゅうすけ	栗原秀輔	固有一般
くりはらもとやす	栗原元康	固有一般
くりはらゆうぞう	栗原勇蔵	固有一般
くりはらいぶらひむじゅにあ	栗原イブラヒムジュニア	固有一般
くりもとひろき	栗本広輝	固有一般
くりやまなおき	栗山直樹	固有一般
くりやまゆうき	栗山裕貴	固有一般
くりわきたくと	栗脇拓人	固有一般
くるまやしんたろう	車屋紳太郎	固有一般
くろいしたかや	黒石貴哉	固有一般
くろうじけいすけ	黒氏啓介	固有一般
くろかわあつし	黒川淳史	固有一般
くろかわけいすけ	黒川圭介	固有一般
くろかわたかや	黒河貴矢	固有一般
くろかわらいへい	黒川雷平	固有一般
くろききょうへい	黒木恭平	固有一般
くろきけんご	黒木謙吾	固有一般
くろきこうけん	黒木晃賢	固有一般
くろきこうへい	黒木晃平	固有一般
くろぎまさと	黒木聖仁	固有一般
くろさきはやと	黒﨑隼人	固有一般
くろさきひさし	黒崎 久志	固有一般
くろせじゅんや	黒瀬純哉	固有一般
くろせともき	黒瀬朋希	固有一般
くろせりひと	黒瀬理仁	固有一般
くろだかいせい	黒田開生	固有一般
くろだたくま	黒田拓真	固有一般
くろつまさる	黒津勝	固有一般
くろのたかと	黒野崇人	固有一般
くろべてるあき	黒部光昭	固有一般
くろみやわたる	黒宮渉	固有一般
くわさきゆうや	鍬先祐弥	固有一般
くわじまりょうた	桑島良汰	固有一般
くわたかずま	鍬田一雅	固有一般
くわたたいせい	桒田大誠	固有一般
くわだしんいちろう	桒田慎一朗	固有一般
くわづるたつき	桑鶴樹	固有一般
くわはらかいと	桑原海人	固有一般
くわはらそうた	桑原颯太	固有一般
くわはらたけし	桑原剛	固有一般
くわはらりくと	桒原陸人	固有一般
くわばらこうた	桑原晃大	固有一般
くわばらひろよし	桑原裕義	固有一般
くわもとゆうじ	桑本ユウジ	固有一般
ぐんじけんたろう	郡司健太朗	固有一般
けいごしゆうじ	慶越雄二	固有一般
けんもつたくむ	監物拓歩	固有一般
げんかんた	玄哉太	固有一般
げんしんてつ	玄新哲	固有一般
げんかちょうた	源河朝太	固有一般
げんだあゆむ	現田歩夢	固有一般
げんぺいやまと	源平倭人	固有一般
こじゅんい	高准翼	固有一般
こじょんうん	高正云	固有一般
こじょんす	高宗秀	固有一般
こいけじゅんき	小池純輝	固有一般
こいけだいき	小池大喜	固有一般
こいけともき	小池知己	固有一般
こいけゆうき	小池悠貴	固有一般
こいけゆうた	小池裕太	固有一般
こいけりゅうた	小池龍太	固有一般
こいけりょうへい	小池良平	固有一般
こいしたつおみ	小石龍臣	固有一般
こいしてつや	小石哲也	固有一般
こいずみけい	小泉慶	固有一般
こいずみけいじ	小泉圭二	固有一般
こいずみさとし	小泉訓	固有一般
こいずみじゅんじ	小泉淳嗣	固有一般
こいずみせいや	小泉靖弥	固有一般
こいずみゆうと	小泉勇人	固有一般
こいずみよしお	小泉佳穂	固有一般
こいでしょうた	小井手翔太	固有一般
こいでゆうた	小出悠太	固有一般
こいどまさあき	小井土正亮	固有一般
こきょんて	髙 慶汰	固有一般
こせうんじん	高昇辰	固有一般
こうたかひろ	高宇洋	固有一般
こうきゆうしん	幸喜祐心	固有一般
こうだひでまさ	甲田英將	固有一般
こうだまさかず	幸田将和	固有一般
こうづきしょうせい	上月翔聖	固有一般
こうづきそういちろう	上月壮一郎	固有一般
こうのあゆむ	河野歩夢	固有一般
こうのしゅうと	幸野志有人	固有一般
こうのじゅんいち	高野純一	固有一般
こうのじゅんご	河野淳吾	固有一般
こうまりょうた	高麗稜太	固有一般
こうもとひろゆき	河本裕之	固有一般
こおろきしんぞう	興梠慎三	固有一般
こえづかかずあき	肥塚一晃	固有一般
こうりひろむ	郡大夢	固有一般
こがかずなり	古賀一成	固有一般
こがけいたろう	古賀鯨太朗	固有一般
こがさとし	古賀聡	固有一般
こがしゅんたろう	古賀俊太郎	固有一般
こがせいじ	古賀誠史	固有一般
こがたいよう	古賀太陽	固有一般
こがたかひろ	古賀貴大	固有一般
こがたくま	古賀琢磨	固有一般
こがまさと	古賀正人	固有一般
こがまさひろ	古賀正紘	固有一般
こくばこじろう	國場虎次朗	固有一般
こくぶしんたろう	國分伸太郎	固有一般
こくぶりゅうじ	國分龍司	固有一般
こくぶんまさし	國分将	固有一般
こくぼじゅん	小久保純	固有一般
こくぼれおぶらいあん	小久保玲央ブライアン	固有一般
こくりょういっぺい	國領 一平	固有一般
こくりょうゆうと	國領雄斗	固有一般
こぐれだいき	小暮大器	固有一般
こぐれふみや	木暮郁哉	固有一般
こけぐちたくや	苔口卓也	固有一般
こさいりょうた	小齋崚太	固有一般
こさかあきのり	小阪昭典	固有一般
こざかいあらた	小酒井新大	固有一般
こざわりゅうき	小澤竜己	固有一般
こしだふた	越田颯太	固有一般
こしみちそうた	越道草太	固有一般
こしもとゆうた	越元佑太	固有一般
こじまけいたつ	小島圭巽	固有一般
こじまけんしょう	小嶋健聖	固有一般
こじましゅうた	小島秀太	固有一般
こじましゅうと	小島秀仁	固有一般
こじまたくし	小島卓	固有一般
こじまのぶゆき	小島伸幸	固有一般
こじまひろみ	小島宏美	固有一般
こじまひろみ	小島弘已	固有一般
こじままさと	小島幹敏	固有一般
こじままさや	小島雅也	固有一般
こじまみつあき	小島光顕	固有一般
こじまりょうすけ	小島亨介	固有一般
こじまりんしろう	小島凛士郎	固有一般
こすがそうし	小菅颯士	固有一般
こすきこうた	小漉康太	固有一般
こすぎけいた	小杉啓太	固有一般
こすぎとしゆき	小杉敏之	固有一般
こすぎはるや	小杉晴也	固有一般
こだけしょん	小竹知恩	固有一般
こたにけんご	小谷健悟	固有一般
こたにひろき	小谷光毅	固有一般
こたにゆうき	小谷祐喜	固有一般
こだまあらた	児玉新	固有一般
こだましゅんと	児玉駿斗	固有一般
こだまじゅん	児玉潤	固有一般
こだまつよし	児玉剛	固有一般
こだまれおと	兒玉澪王斗	固有一般
こづかかずき	小塚和季	固有一般
こてがわこうき	小手川宏基	固有一般
こてつゆうたろう	小鉄雄太郎	固有一般
こてらかずき	小寺一生	固有一般
こてらゆうき	小寺優輝	固有一般
こながやちひろ	古長谷千博	固有一般
こにしひなた	小西陽向	固有一般
こにしゆうだい	小西雄大	固有一般
こにしりょうま	小西龍馬	固有一般
このゆうと	古野優斗	固有一般
このしまらい	此島頼勇	固有一般
こはつたつき	古波津辰希	固有一般
こはらのぼる	小原昇	固有一般
こばかいと	木場海斗	固有一般
こばひぬた	木塲暖太	固有一般
こばしじょう	小橋丈	固有一般
こばやしいわな	小林岩魚	固有一般
こばやしかいと	小林海翔	固有一般
こばやしかいや	小林海也	固有一般
こばやしかずや	小林和矢	固有一般
こばやしかん	小林幹	固有一般
こばやしけいた	小林慶太	固有一般
こばやしさとる	小林悟	固有一般
こばやししょうた	古林将太	固有一般
こばやししょうま	小林章馬	固有一般
こばやしじゅん	小林洵	固有一般
こばやしせいごう	小林成豪	固有一般
こばやしそういちろう	小林壮一郎	固有一般
こばやしたいよう	小林太陽	固有一般
こばやしたかみち	小林高道	固有一般
こばやしたくみ	小林巧弥	固有一般
こばやしたつき	小林竜樹	固有一般
こばやしだいご	小林大悟	固有一般
こばやしだいち	小林大智	固有一般
こばやしてるあき	小林久晃	固有一般
こばやしともみつ	小林智光	固有一般
こばやしなつき	小林夏生	固有一般
こばやしひでまさ	小林秀征	固有一般
こばやしひろき	小林弘記	固有一般
こばやしひろと	小林洸翔	固有一般
こばやしひろゆき	小林宏之	固有一般
こばやしまお	小林真鷹	固有一般
こばやしまこと	小林誠	固有一般
こばやしまさたか	小林将天	固有一般
こばやしまさみつ	小林成光	固有一般
こばやしみのる	小林稔	固有一般
こばやしやすたか	小林康剛	固有一般
こばやしゆう	小林悠	固有一般
こばやしゆうき	小林祐希	固有一般
こばやしゆき	小林友希	固有一般
こばやしゆうき	小林裕紀	固有一般
こばやしゆうき	小林優希	固有一般
こばやしゆうすけ	小林祐介	固有一般
こばやしゆうぞう	小林祐三	固有一般
こばやしゆうた	小林祐太	固有一般
こばやしようすけ	小林陽介	固有一般
こばやしよしゆき	小林慶行	固有一般
こばやしりく	小林里駆	固有一般
こばやしりく	小林陸玖	固有一般
こばやしりょう	小林亮	固有一般
こばやしりょうた	小林亮太	固有一般
こばらしょうご	小原章吾	固有一般
こばりきよみつ	小針清允	固有一般
こぶきしょうた	木吹翔太	固有一般
こぼりそら	小堀空	固有一般
こまいゆきひろ	駒井幸弘	固有一般
こまいよしあき	駒井善成	固有一般
こまきまさのぶ	小牧成亘	固有一般
こまたけんじ	古俣健次	固有一般
こまつけんた	小松憲太	固有一般
こまつしゅんだい	小松隼大	固有一般
こまつたくみ	小松拓幹	固有一般
こまつはやた	小松駿太	固有一般
こまつゆうと	小松雄音	固有一般
こまつるい	小松塁	固有一般
こまつれん	小松蓮	固有一般
こまつざきたもつ	小松崎保	固有一般
こまつばらまなぶ	小松原学	固有一般
こまのゆういち	駒野友一	固有一般
こみようた	小見洋太	固有一般
こみねたかゆき	小峯隆幸	固有一般
こみねたくや	小峯拓也	固有一般
こみやまさき	小宮真輝	固有一般
こみやまたかのぶ	小宮山尊信	固有一般
こむたようすけ	小牟田洋佑	固有一般
こもりひいろ	小森飛絢	固有一般
こもりだともあき	小森田友明	固有一般
こやただし	小屋禎	固有一般
こやけたかと	小宅空大	固有一般
こやなぎたつし	小柳達司	固有一般
こやのけんじ	小谷野顕治	固有一般
こやまあきら	小山彬	固有一般
こやまあらた	小山新	固有一般
こやまけんじ	小山健二	固有一般
こやましゅり	小山珠里	固有一般
こやましょうや	小山聖也	固有一般
こやまじょうい	小山丈偉	固有一般
こやまたくと	小山拓土	固有一般
こやまたくや	小山拓哉	固有一般
こやままお	小山真生	固有一般
こやまつともや	小屋松知哉	固有一般
これだしんご	是枝真伍	固有一般
こんどういっせい	近藤壱成	固有一般
こんどうかんた	近藤貫太	固有一般
こんどうがくとく	近藤岳登	固有一般
こんどうくらば	近藤蔵波	固有一般
こんどうこうじ	今藤幸治	固有一般
こんどうしゅうご	近藤嵩悟	固有一般
こんどうしんご	近藤慎吾	固有一般
こんどうたかし	近藤貴司	固有一般
こんどうたかとら	近藤高虎	固有一般
こんどうてつし	近藤徹志	固有一般
こんどうともき	近藤友喜	固有一般
こんどうなおや	近藤直也	固有一般
こんどうやまと	近藤大和	固有一般
こんどうゆうすけ	近藤祐介	固有一般
こんどうよしひと	近藤慶一	固有一般
こんどうりくと	近藤陸翔	固有一般
こんのあきら	今野章	固有一般
こんのいぶき	今野息吹	固有一般
こんのかずや	紺野和也	固有一般
こんのかつひろ	近野勝大	固有一般
こんのそういちろう	今野聡一郎	固有一般
こんのたいすけ	今野太祐	固有一般
こんのひろや	今野滉也	固有一般
こんのやすゆき	今野泰幸	固有一般
こんのゆむ	今野勇夢	固有一般
ごだいむ	呉大陸	固有一般
ごうたつや	郷達哉	固有一般
ごうけゆうた	郷家友太	固有一般
ごうしひろかず	郷司弘和	固有一般
ごうだこうき	合田光希	固有一般
ごきゅうしょう	御給匠	固有一般
ごとうきょうすけ	後藤京介	固有一般
ごとうけいすけ	後藤啓介	固有一般
ごとうけいた	後藤圭太	固有一般
ごとうけいた	後藤啓太	固有一般
ごとうこうすけ	後藤虹介	固有一般
ごとうじゅんじ	後藤純二	固有一般
ごとうたくま	後藤卓磨	固有一般
ごとうたろう	後藤太郎	固有一般
ごとうだいき	後藤大輝	固有一般
ごとうなおき	後東尚輝	固有一般
ごとうひびき	後藤響	固有一般
ごとうまさあき	後藤雅明	固有一般
ごとうゆうじ	後藤裕司	固有一般
ごとうゆうすけ	後藤佑介	固有一般
ごとうゆうすけ	後藤優介	固有一般
ごとうゆうへい	後藤雄平	固有一般
ごとうゆうや	後藤佑也	固有一般
ごとうよしかず	後藤義一	固有一般
ごとうりょう	後藤涼	固有一般
ごとうわたる	後藤亘	固有一般
ごとうだこうき	後藤田亘輝	固有一般
ごみいくと	五味郁登	固有一般
ごやひろと	呉屋大翔	固有一般
ごりょうじゅんき	五領淳樹	固有一般
ごんだしゅういち	権田修一	固有一般
ごんどうゆうすけ	権東勇介	固有一般
さいかわゆうすけ	斉川雄介	固有一般
さいきかずと	斉木和人	固有一般
さいじょうきょうや	西城響也	固有一般
さいとうかずき	齋藤和希	固有一般
さいとうかずき	齊藤和樹	固有一般
さいとうかつゆき	斎藤克幸	固有一般
さいとうかんた	齊藤貫太	固有一般
さいとうきよし	斉藤紀由	固有一般
さいとうけいた	齋藤恵太	固有一般
さいとうけいと	斎藤恵人	固有一般
さいとうけんじろう	齋藤謙二郎	固有一般
さいとうこうき	斉藤光毅	固有一般
さいとうこうすけ	齋藤功佑	固有一般
さいとうこうすけ	齋藤滉介	固有一般
さいとうこうた	斎藤宏太	固有一般
さいとうこうや	斎藤広野	固有一般
さいとうしょうた	齋藤翔太	固有一般
さいとうしょうた	斎藤翔太	固有一般
さいとうじゅんぺい	斎藤純平	固有一般
さいとうせいいち	斉藤誠一	固有一般
さいとうせな	齊藤聖七	固有一般
さいとうそうた	斎藤聡太	固有一般
さいとうたかし	齋藤恭志	固有一般
さいとうたけし	斉藤武志	固有一般
さいとうだいき	齊藤大輝	固有一般
さいとうだいじゅ	斎藤大珠	固有一般
さいとうだいすけ	斉藤大介	固有一般
さいとうだいすけ	斎藤大輔	固有一般
さいとうとしひで	斉藤俊秀	固有一般
さいとうひろし	斉藤浩史	固有一般
さいとうまさき	齋藤将基	固有一般
さいとうまさと	斉藤雅人	固有一般
さいとうまさや	斎藤雅也	固有一般
さいとうまなぶ	齋藤学	固有一般
さいとうみつき	齊藤未月	固有一般
さいとうゆうま	斉藤勇真	固有一般
さいとうゆずき	斉藤柚樹	固有一般
さいとうようすけ	斎藤陽介	固有一般
さいとうようた	齊藤洋大	固有一般
さいとうよのすけ	齋藤耀之介	固有一般
さいとうよしと	齊藤慈斗	固有一般
さいとうりゅう	齋藤竜	固有一般
さいとうりゅうじ	才藤龍治	固有一般
さいとうりゅうせい	齊藤隆成	固有一般
さいとうりょう	斉藤諒	固有一般
さいとうりょう	齋藤遼	固有一般
さえきけいた	佐伯啓太	固有一般
さえきしんのすけ	佐伯清之助	固有一般
さえきなおや	佐伯直哉	固有一般
さえきりゅうせい	佐伯竜征	固有一般
さえきれん	佐伯蓮	固有一般
さかけいすけ	坂圭祐	固有一般
さかいけんたろう	栄井健太郎	固有一般
さかいごうそん	酒井高聖	固有一般
さかいごとう	酒井高徳	固有一般
さかいしゅいち	酒井崇一	固有一般
さかいしゅんや	坂井駿也	固有一般
さかいしょうご	坂井将吾	固有一般
さかいたかまさ	酒井貴政	固有一般
さかいたくみ	酒井匠	固有一般
さかいたつま	酒井達磨	固有一般
さかいたつや	坂井達弥	固有一般
さかいだいすけ	坂井大将	固有一般
さかいとしき	堺俊暉	固有一般
さかいともゆき	酒井友之	固有一般
さかいなおき	酒井直樹	固有一般
さかいのりよし	酒井宣福	固有一般
さかいはるか	阪井暖	固有一般
さかいひろき	酒井宏樹	固有一般
さかいひろし	坂井浩	固有一般
さかいひろと	酒井大登	固有一般
さかいまさき	酒井将輝	固有一般
さかいゆうき	酒井湧暉	固有一般
さかいようじ	堺陽二	固有一般
さかいようへい	坂井洋平	固有一般
さかいりゅうすけ	酒井隆介	固有一般
さかいりょう	酒井良	固有一般
さかいやけいすけ	堺屋佳介	固有一般
さかきしょうた	榊翔太	固有一般
さかきばらきょうた	榊原杏太	固有一般
さかきばらけいご	榊原彗悟	固有一般
さかくらゆうじ	阪倉裕二	固有一般
さかぐちけんじ	坂口健司	固有一般
さかぐちしょうい	坂口祥尉	固有一般
さかぐちそうた	阪口颯汰	固有一般
さかたあきひろ	阪田章裕	固有一般
さかただいき	坂田大樹	固有一般
さかただいすけ	坂田大輔	固有一般
さかたりょうた	坂田良太	固有一般
さかたれいや	阪田澪哉	固有一般
さかのとよふみ	阪野豊史	固有一般
さかもといおり	坂元一渚璃	固有一般
さかもといさ	坂本一彩	固有一般
さかもとかける	坂本翔	固有一般
さかもとかずと	阪本一仁	固有一般
さかもとかんた	坂本勘汰	固有一般
さかもときりや	坂本稀吏也	固有一般
さかもとけい	坂本敬	固有一般
さかもとけいすけ	坂本圭佑	固有一般
さかもとこうき	坂本亘基	固有一般
さかもとこうじ	坂本紘司	固有一般
さかもとこだい	坂本広大	固有一般
さかもとしゅうすけ	坂本修佑	固有一般
さかもとしょういちろう	阪本翔一朗	固有一般
さかもとじゅんぺい	坂本順平	固有一般
さかもとたけひさ	坂本武久	固有一般
さかもとたつひろ	坂元達裕	固有一般
さかもとだいき	坂元大希	固有一般
さかもとひろゆき	坂本寛之	固有一般
さかもとまさき	阪本将基	固有一般
さかもとまさたか	坂本將貴	固有一般
さかもとようすけ	坂元要介	固有一般
さかもとよしゆき	坂本義行	固有一般
さかもとるい	坂本琉維	固有一般
さかもとれい	坂本玲	固有一般
さがいっぺい	佐賀一平	固有一般
さがりく	嵯峨理久	固有一般
さがらりゅうのすけ	相良竜之介	固有一般
さがわこうすけ	佐川洸介	固有一般
さがわりょうすけ	佐川亮介	固有一般
さきむらゆうすけ	崎村祐丞	固有一般
さきもとしんすけ	嵜本晋輔	固有一般
さくたりゅうたろう	作田龍太郎	固有一般
さくだゆうじ	作田裕次	固有一般
さくはらしょう	作原翔	固有一般
さくまたいち	佐久間太一	固有一般
さくまはねと	佐久間翔士	固有一般
さくまりょう	佐久間遼	固有一般
さくらいしげる	桜井繁	固有一般
さくらいしょうご	桜井鐘吾	固有一般
さくらいたかし	桜井孝司	固有一般
さくらいたつのり	櫻井辰徳	固有一般
さくらいなおと	桜井直人	固有一般
さくらいふうが	櫻井風我	固有一般
さくらいまさと	桜井正人	固有一般
さくらうちなぎさ	櫻内渚	固有一般
さくらがわそろもん	櫻川ソロモン	固有一般
さくらぎりょうた	桜木亮太	固有一般
さくらだかずき	櫻田和樹	固有一般
さくらだりょうが	桜田凌雅	固有一般
さくらばりき	櫻庭立樹	固有一般
さけもとのりゆき	酒本憲幸	固有一般
さこあらた	佐古創	固有一般
さこたいち	迫大智	固有一般
さこまあや	佐古真礼	固有一般
さこいしんや	迫井深也	固有一般
さこりくと	酒向陸斗	固有一般
ささあゆむ	笹歩睦	固有一般
ささがきたくや	笹垣拓也	固有一般
ささがきりょうすけ	笹垣亮介	固有一般
ささきあさひ	佐々木旭	固有一般
ささきいっき	佐々木一輝	固有一般
ささきかい	佐々木快	固有一般
ささきけいた	佐々木啓太	固有一般
ささきしょう	佐々木翔	固有一般
ささきしょうご	佐々木翔悟	固有一般
ささきそうた	佐々木奏太	固有一般
ささきそうたろう	佐々木想太郎	固有一般
ささきたいじゅ	佐々木大樹	固有一般
ささきたかひろ	佐々木崇浩	固有一般
ささきたかや	佐々木貴哉	固有一般
ささきたくみ	佐々木匠	固有一般
ささきただし	佐々木善	固有一般
ささきだいき	佐々木大貴	固有一般
ささきだいじゅ	佐々木大樹	固有一般
ささきつばさ	佐々木翼	固有一般
ささきはやと	佐々木勇人	固有一般
ささきひとし	佐々木仁	固有一般
ささきひろかず	佐々木博和	固有一般
ささきひろき	佐々木宏樹	固有一般
ささきまさと	佐々木雅人	固有一般
ささきまさと	佐々木雅士	固有一般
ささきまさなお	佐々木雅尚	固有一般
ささきゆうすけ	佐々木勇輔	固有一般
ささきゆうた	佐々木祐太	固有一般
ささきゆうり	佐々木優吏	固有一般
ささきようじ	佐々木陽次	固有一般
ささきりくお	佐々木陸生	固有一般
ささきりゅうた	佐々木竜太	固有一般
ささきわたる	佐々木渉	固有一般
ささはらけんしん	笹原堅信	固有一般
ささはらしゅうへい	笹原脩平	固有一般
ささはらのぶひで	笹原伸秀	固有一般
ささはらよしみ	笹原義巳	固有一般
ささやまりのん	笹山琉暢	固有一般
さしなみゆうと	差波優人	固有一般
さそうかずあき	佐相壱明	固有一般
さたひでや	佐多秀哉	固有一般
さだそたろう	佐田聡太郎	固有一般
さだとみのぶひろ	貞富信宏	固有一般
さだもとけいき	定本佳樹	固有一般
さつかわあつき	薩川淳貴	固有一般
さつかわのりひろ	薩川了洋	固有一般
さつきだせいや	五月田星矢	固有一般
さつかようすけ	佐塚洋介	固有一般
さとうあおい	佐藤碧	固有一般
さとうあきひろ	佐藤昭大	固有一般
さとうあきひろ	佐藤晃大	固有一般
さとうあさひ	佐藤旭	固有一般
さとうえいじ	佐藤英二	固有一般
さとうおおみ	佐藤大実	固有一般
さとうかいと	佐藤海斗	固有一般
さとうかずき	佐藤一樹	固有一般
さとうかずき	佐藤和樹	固有一般
さとうかずと	佐藤和斗	固有一般
さとうかずひろ	佐藤和弘	固有一般
さとうかんた	佐藤勘太	固有一般
さとうかんた	佐藤幹太	固有一般
さとうきょう	佐藤響	固有一般
さとうけいすけ	佐藤恵介	固有一般
さとうけんすけ	佐藤謙介	固有一般
さとうけんたろう	佐藤健太郎	固有一般
さとうこういち	佐藤洸一	固有一般
さとうこうき	佐藤幸生	固有一般
さとうこうだい	佐藤幸大	固有一般
さとうこうよう	佐藤昂洋	固有一般
さとうさとし	佐藤聡	固有一般
さとうしゅん	佐藤隼	固有一般
さとうしょう	佐藤祥	固有一般
さとうしょうきち	佐藤昌吉	固有一般
さとうしんいち	佐藤真一	固有一般
さとうしんや	佐藤真也	固有一般
さとうじゅん	佐藤潤	固有一般
さとうじゅんき	佐藤遵樹	固有一般
さとうじゅんじ	佐藤淳志	固有一般
さとうじょうせい	佐藤丈晟	固有一般
さとうじん	佐藤尽	固有一般
さとうすばる	佐藤昴	固有一般
さとうそうた	佐藤颯汰	固有一般
さとうそうま	佐藤颯真	固有一般
さとうたいが	佐藤大雅	固有一般
さとうたいすけ	佐藤太亮	固有一般
さとうたいせい	佐藤大晴	固有一般
さとうたいち	佐藤太一	固有一般
さとうたいてん	佐藤大典	固有一般
さとうだい	佐藤大	固有一般
さとうだいき	佐藤大基	固有一般
さとうだいき	佐藤大樹	固有一般
さとうつよし	佐藤健	固有一般
さとうとしや	佐藤俊哉	固有一般
さとうなおき	佐藤尚輝	固有一般
さとうはやと	佐藤颯人	固有一般
さとうはると	佐藤遥翔	固有一般
さとうひろひこ	佐藤陽彦	固有一般
さとうひさき	佐藤尚生	固有一般
さとうひさと	佐藤寿人	固有一般
さとうひさや	佐藤久弥	固有一般
さとうひろし	佐藤浩	固有一般
さとうひろと	佐藤大翔	固有一般
さとうまさみ	佐藤正美	固有一般
さとうまさや	佐藤将也	固有一般
さとうみくや	佐藤未来也	固有一般
さとうみのる	佐藤穣	固有一般
さとうみひろ	佐藤海宏	固有一般
さとうみゆ	佐藤未勇	固有一般
さとうやすゆき	佐藤康之	固有一般
さとうゆうあん	佐藤悠安	固有一般
さとうゆいと	佐藤唯斗	固有一般
さとうゆうき	佐藤悠希	固有一般
さとうゆうし	佐藤有志	固有一般
さとうゆうすけ	佐藤悠介	固有一般
さとうゆうせい	佐藤勇盛	固有一般
さとうゆうた	佐藤祐太	固有一般
さとうゆうた	佐藤勇大	固有一般
さとうゆうと	佐藤勇人	固有一般
さとうゆうへい	佐藤優平	固有一般
さとうゆうや	佐藤優也	固有一般
さとうゆきひこ	佐藤由紀彦	固有一般
さとうようせい	佐藤陽成	固有一般
さとうようた	佐藤瑶大	固有一般
さとうようへい	佐藤洋平	固有一般
さとうよしあき	佐藤慶明	固有一般
さとうよしき	佐藤喜生	固有一般
さとうりき	佐藤璃樹	固有一般
さとうりくと	佐藤陸人	固有一般
さとうりゅうせい	佐藤瑠星	固有一般
さとうりゅうのすけ	佐藤龍之介	固有一般
さとうりょう	佐藤亮	固有一般
さとうりょう	佐藤諒	固有一般
さとうりょうが	佐藤凌我	固有一般
さとうれいすけ	佐藤伶介	固有一般
さとおかりゅうと	里岡龍人	固有一般
さとみひとよし	里見仁義	固有一般
さとみりゅうたろう	里見龍太郎	固有一般
さとりかいと	左部開斗	固有一般
さなだこうた	真田幸太	固有一般
さなだまさのり	真田雅則	固有一般
さねとゆき	實藤友紀	固有一般
さねのぶのりあき	実信憲明	固有一般
さねよしのりただ	實好礼忠	固有一般
さのかいしゅう	佐野海舟	固有一般
さのこうだい	佐野航大	固有一般
さのつばさ	佐野翼	固有一般
さのともあき	佐野友昭	固有一般
さのゆうや	佐野裕哉	固有一般
さのりくと	佐野陸人	固有一般
さのりくほ	佐野陸歩	固有一般
さはしとうま	佐橋杜真	固有一般
さはらひでき	佐原秀樹	固有一般
さほこうへい	佐保昂兵衛	固有一般
さめしまああと	鮫島亜々斗	固有一般
さめしまこうた	鮫島晃太	固有一般
さららりつき	皿良立輝	固有一般
さるたはるき	猿田遥己	固有一般
さるたひろのり	猿田浩得	固有一般
さわまさかつ	澤昌克	固有一般
さわいなおと	澤井直人	固有一般
さわいりしげお	沢入重雄	固有一般
さわかみりゅうじ	澤上竜二	固有一般
さわぐちまさひこ	澤口雅彦	固有一般
さわざきりょうた	澤崎凌大	固有一般
さわしまあきら	澤島輝	固有一般
さわだあつき	澤田篤樹	固有一般
さわだかずき	澤田和樹	固有一般
さわだけんた	澤田健太	固有一般
さわだけんたろう	沢田謙太郎	固有一般
さわだこう	澤田恒	固有一般
さわだしょう	澤田将	固有一般
さわだしょうご	澤田章吾	固有一般
さわだたかし	澤田崇	固有一般
さわだひろゆき	澤田博行	固有一般
さわのぼりまさあき	澤登正朗	固有一般
さんだなおき	三田尚希	固有一般
さんだんばたあつき	三反畑篤樹	固有一般
さんとすあでみーる	三渡洲アデミール	固有一般
さんとすあれさんどろ	三都主 アレサンドロ	固有一般
さんとすまいと	三渡洲舞人	固有一般
さんぼんすげたかし	三本菅崇	固有一般
ざいぜんけいいち	財前恵一	固有一般
ざいぜんのぶゆき	財前宣之	固有一般
ざいつしゅんいちろう	財津俊一郎	固有一般
しいなかずま	椎名一馬	固有一般
しいなのぶゆき	椎名伸志	固有一般
しいはしけいや	椎橋慧也	固有一般
しいはらたくや	椎原拓也	固有一般
しおかわたけと	塩川岳人	固有一般
しおざきしょう	塩﨑彰	固有一般
しおざわしょうご	塩沢勝吾	固有一般
しおざわたつや	塩沢達也	固有一般
しおたひとし	塩田仁史	固有一般
しおたにしんすけ	塩谷伸介	固有一般
しおたにつかさ	塩谷司	固有一般
しおのそら	塩野空	固有一般
しおはまりょう	塩浜遼	固有一般
しかのしゅうへい	鹿野修平	固有一般
しかのふうた	鹿野楓太	固有一般
しかまゆうき	色摩雄貴	固有一般
しかやまたくま	鹿山拓真	固有一般
しがきじえい	紫垣慈瑛	固有一般
しきだたかよし	式田高義	固有一般
しきだゆい	敷田唯	固有一般
しげたいら	茂平	固有一般
しげさだそう	繁定蒼	固有一般
しげたゆきのり	重田征紀	固有一般
しげはらたけひと	茂原岳人	固有一般
しげひろたくや	重廣卓也	固有一般
しげまつけんたろう	重松健太郎	固有一般
しげみまさと	重見柾斗	固有一般
しげみつたかあき	重光貴葵	固有一般
しだいずほ	志田出帆	固有一般
しちたかあき	志知孝明	固有一般
しながわだいき	品川大輝	固有一般
しなだたろう	品田太郎	固有一般
しなだまなと	品田愛斗	固有一般
しのざきしょうき	篠崎清輝	固有一般
しのざきてるかず	篠崎輝和	固有一般
しのだよしのり	篠田善之	固有一般
しのはらこうじろう	篠原弘次郎	固有一般
しのはらともや	篠原友哉	固有一般
しのはらひろひと	篠原宏仁	固有一般
しのはらゆうだい	篠原佑岳	固有一般
しのみやゆうせい	四宮悠成	固有一般
しのもりらい	篠森羅唯	固有一般
しばけいた	柴圭汰	固有一般
しばのぶひろ	柴暢彦	固有一般
しばこやゆういち	柴小屋雄一	固有一般
しばさきかいと	柴﨑海翔	固有一般
しばさきがく	柴崎岳	固有一般
しばさきこうせい	柴﨑 晃誠	固有一般
しばさきたかひろ	柴崎貴広	固有一般
しばざきくにひろ	柴崎邦博	固有一般
しばたこうじろう	柴田航次郎	固有一般
しばたしょう	芝田将	固有一般
しばたしんご	柴田慎吾	固有一般
しばたそうすけ	柴田壮介	固有一般
しばただいち	柴田大地	固有一般
しばたとおる	柴田徹	固有一般
しばたりゅうたろう	柴田隆太朗	固有一般
しばとかい	柴戸海	固有一般
しばはらまこと	柴原誠	固有一般
しばむらなおや	柴村直弥	固有一般
しばもとれん	芝本蓮	固有一般
しばやままさや	柴山昌也	固有一般
しぶやつばさ	渋谷飛翔	固有一般
しぶやまさや	澁谷雅也	固有一般
しぶやりょう	渋谷亮	固有一般
しまたくし	島卓視	固有一般
しまおかけんた	島岡健太	固有一般
しまかわとしお	島川俊郎	固有一般
しまがきしょう	島垣翔	固有一般
しまさきゆう	島嵜佑	固有一般
しまざききょうへい	島崎恭平	固有一般
しまざきはじめ	島崎元	固有一般
しまづとらし	島津虎史	固有一般
しまだしゅうすけ	島田周輔	固有一般
しまだしょうご	嶋田正吾	固有一般
しまだしんたろう	嶋田慎太郎	固有一般
しまだたかひろ	島田貴裕	固有一般
しまだたくみ	島田拓海	固有一般
しまだはると	島田春人	固有一般
しまだゆうき	島田祐輝	固有一般
しまだゆうすけ	島田裕介	固有一般
しまだゆずる	島田譲	固有一般
しまづゆあん	嶋津柚杏	固有一般
しまづらいせい	島津頼盛	固有一般
しまぬきじゅん	島貫純	固有一般
しまぶくろしんすけ	島袋信介	固有一般
しまむらたくや	島村拓弥	固有一般
しまむらつよし	島村毅	固有一般
しまむらまさし	島村征志	固有一般
しまむられいの	島村麗乃	固有一般
しまややつのり	島屋八徳	固有一般
しみずあつき	清水敦貴	固有一般
しみずかずお	清水和男	固有一般
しみずかずまさ	清水和昌	固有一般
しみずかずまさ	清水一雅	固有一般
しみずけいき	清水慶記	固有一般
しみずけいすけ	清水圭介	固有一般
しみずけんた	清水健太	固有一般
しみずこうへい	清水航平	固有一般
しみずこうや	清水康也	固有一般
しみずしんたろう	清水慎太郎	固有一般
しみずじゅん	清水純	固有一般
しみずせいりゅう	清水星竜	固有一般
しみずたいち	清水太一	固有一般
しみずたかふみ	清水貴文	固有一般
しみずたけし	清水武士	固有一般
しみずつばさ	清水大翔	固有一般
しみずのりひさ	清水範久	固有一般
しみずはるき	清水春樹	固有一般
しみずひかる	清水光	固有一般
しみずひらい	清水飛来	固有一般
しみずまなと	清水愛都	固有一般
しみずゆうと	清水悠斗	固有一般
しみずようすけ	清水陽介	固有一般
しみずらい	清水羅偉	固有一般
しみずりょうま	清水綾馬	固有一般
しむらこう	志村滉	固有一般
しむらしゅんた	志村駿太	固有一般
しむらのぼる	志村謄	固有一般
しむらひろき	志村弘樹	固有一般
しもかわけんいち	下川健一	固有一般
しもかわせいご	下川誠吾	固有一般
しもかわたいよう	下川太陽	固有一般
しもかわてつや	下川哲矢	固有一般
しもかわはるき	下川陽輝	固有一般
しもかわまさと	下川雅人	固有一般
しもかわようた	下川陽太	固有一般
しもがみしょうた	下上昇大	固有一般
しもぐちわかば	下口稚葉	固有一般
しもさかこうき	下坂晃城	固有一般
しもざわゆうた	下澤悠太	固有一般
しもしりゅうじ	下司隆士	固有一般
しもじしょう	下地奨	固有一般
しもたいらたかひろ	下平隆宏	固有一般
しもだこうへい	下田光平	固有一般
しもだたかし	下田崇	固有一般
しもだほくと	下田北斗	固有一般
しもだよしひろ	下田栄祐	固有一般
しもどうりゅうせい	下堂竜聖	固有一般
しもなかりょうが	下中凌我	固有一般
しもはたしょうご	下畠翔吾	固有一般
しもはらりく	下原凌空	固有一般
しもひらたくみ	下平匠	固有一般
しもむらとみ	下村東美	固有一般
しもむらゆうた	下村悠太	固有一般
しゅうゆいち	周余冶	固有一般
しゅぎょうともひと	修行智仁	固有一般
しゅとうこうた	首藤光翼	固有一般
しゅないだーじゅんのすけ	シュナイダー潤之介	固有一般
しょうじけいたろう	庄司啓太郎	固有一般
しょうじげん	昌子源	固有一般
しょうじそらのすけ	庄司宙ノ介	固有一般
しょうじたいち	東海林泰地	固有一般
しょうじたかし	庄司孝	固有一般
しょうじほのや	庄司朋乃也	固有一般
しょうじよしひろ	庄司悦大	固有一般
しょうないこうた	庄内航汰	固有一般
しょうむらともき	正村友希	固有一般
しらいあつし	白井淳	固有一般
しらいえいじ	白井永地	固有一般
しらいこうすけ	白井康介	固有一般
しらいしゅうへい	白井脩平	固有一般
しらいたくと	白井卓翔	固有一般
しらいたつや	白井達也	固有一般
しらいはるき	白井陽貴	固有一般
しらいはると	白井陽斗	固有一般
しらいひろゆき	白井博幸	固有一般
しらいゆうと	白井裕人	固有一般
しらいりょうすけ	白井亮丞	固有一般
しらいしけん	白石健	固有一般
しらいしともゆき	白石智之	固有一般
しらおひでひと	白尾秀人	固有一般
しらおかてぃもしぃ	白岡ティモシィ	固有一般
しらがなおき	白神端基	固有一般
しらさかふうま	白坂楓馬	固有一般
しらさきりょうへい	白崎凌兵	固有一般
しらすけんと	白須健斗	固有一般
しらたにけんと	白谷建人	固有一般
しらとだいき	白土大貴	固有一般
しらとりゆうと	白鳥悠仁	固有一般
しらはまそうじろう	白濱聡二郎	固有一般
しろたあつし	代田敦資	固有一般
しろみずこうた	城水晃太	固有一般
しろわはやて	城和隼颯	固有一般
しんこうへい	進昂平	固有一般
しんちぼん	申在範	固有一般
しんびょんほ	申秉皓	固有一般
しんゆうたろう	新裕太朗	固有一般
しんりょうすけ	新良介	固有一般
しんぎょうじかずひこ	眞行寺和彦	固有一般
しんざとしょうへい	新里彰平	固有一般
しんざとりょう	新里亮	固有一般
しんざわだいち	新澤大知	固有一般
しんじょうはるき	新城暖基	固有一般
しんじょうひろき	新條宏喜	固有一般
しんじょうまなと	新城愛斗	固有一般
しんちゅうつよし	新中剛史	固有一般
しんとうかつよし	信藤 健仁	固有一般
しんどうせいじ	進藤誠司	固有一般
しんどうりょうすけ	進藤亮佑	固有一般
しんぼかいり	新保海鈴	固有一般
しんみょうまさひろ	新明正広	固有一般
しんみょうりゅうた	新明龍太	固有一般
しんむらじゅんぺい	新村純平	固有一般
じとうぞのまさや	地頭薗雅弥	固有一般
じぬしぞのひでみ	地主園秀美	固有一般
じゃーめいんりょう	ジャーメイン良	固有一般
じょしょうひ	徐暁飛	固有一般
じょうしょうじ	城彰二	固有一般
じょうごひさし	城後寿	固有一般
じょうじょうかんた	城定幹大	固有一般
じょうじょうしんじ	城定信次	固有一般
じょうにししゅんだい	上西駿大	固有一般
じょうもりやすたか	城森康誉	固有一般
ちょんじんほ	鄭震浩	固有一般
じょんとうほ	丁 東浩	固有一般
じんのたくや	神野卓哉	固有一般
すえおかりゅうじ	末岡龍二	固有一般
すえきひろや	末木裕也	固有一般
すえつぐあつき	末次敦貴	固有一般
すえつぐしょうご	末次章悟	固有一般
すえつぐはやて	末次颯	固有一般
すえながとうあ	末永透瑛	固有一般
すえよしとしや	末吉隼也	固有一般
すえよしるい	末吉塁	固有一般
すがだいき	菅大輝	固有一般
すがいたくや	菅井拓也	固有一般
すがいなおき	菅井直樹	固有一般
すがいひでひろ	須貝英大	固有一般
すがじまひろき	菅嶋弘希	固有一般
すがたまさひろ	菅田真啓	固有一般
すがぬまかずあき	菅沼一晃	固有一般
すがぬましゅんや	菅沼駿哉	固有一般
すがぬまみのる	菅沼実	固有一般
すがのけんいち	菅野賢一	固有一般
すがのたくま	菅野拓真	固有一般
すがのはる	菅野波琉	固有一般
すがのりゅうせい	菅野隆星	固有一般
すがはらたろう	菅原太郎	固有一般
すがもとがく	菅本岳	固有一般
すがやしゅうと	菅谷脩人	固有一般
すがわらこうた	菅原康太	固有一般
すがわらしゅうと	菅原脩斗	固有一般
すがわらしんり	菅原心里	固有一般
すがわらたいき	菅原大幹	固有一般
すがわらとも	菅原智	固有一般
すがわらひろみち	菅原大道	固有一般
すがわらゆきなり	菅原由勢	固有一般
すがわらりゅうのすけ	菅原龍之助	固有一般
すきがらまさひろ	鋤柄昌宏	固有一般
すぎいはやて	杉井颯	固有一般
すぎうらきょうへい	杉浦恭平	固有一般
すぎうらしゅんご	杉浦駿吾	固有一般
すぎうらふみや	杉浦文哉	固有一般
すぎうらりきと	杉浦力斗	固有一般
すぎおかだいき	杉岡大暉	固有一般
すぎさきこうすけ	杉﨑皐輔	固有一般
すぎたはやと	杉田隼	固有一般
すぎたまさひこ	杉田真彦	固有一般
すぎたまさひろ	杉田将宏	固有一般
すぎのけんと	杉野健斗	固有一般
すぎのしんたろう	杉野伸太朗	固有一般
すぎのたいちろう	杉野太一朗	固有一般
すぎむらしゅんすけ	杉村駿介	固有一般
すぎもとけい	杉本圭	固有一般
すぎもとけいた	杉本恵太	固有一般
すぎもとけんゆう	杉本健勇	固有一般
すぎもとそうたろう	杉本崇太朗	固有一般
すぎもとたいが	杉本大雅	固有一般
すぎもとたくや	杉本拓也	固有一般
すぎもとたろう	杉本太郎	固有一般
すぎもとだいち	杉本大地	固有一般
すぎもとひろゆき	杉本裕之	固有一般
すぎもとまこと	杉本真	固有一般
すぎもとまさお	杉本雅央	固有一般
すぎもとまさや	杉本将哉	固有一般
すぎもとみちはる	杉本倫治	固有一般
すぎもとみつき	杉本光希	固有一般
すぎもとりゅうじ	杉本竜士	固有一般
すぎもりこうき	杉森考起	固有一般
すぎやまあらた	杉山新	固有一般
すぎやまこういち	杉山弘一	固有一般
すぎやまこうじ	杉山耕二	固有一般
すぎやまこうた	杉山浩太	固有一般
すぎやましゅん	杉山俊	固有一般
すぎやましん	杉山臣	固有一般
すぎやまたかまさ	杉山天真	固有一般
すぎやまたかゆき	杉山貴之	固有一般
すぎやまたくや	杉山琢也	固有一般
すぎやまだんと	杉山弾斗	固有一般
すぎやまてつ	杉山哲	固有一般
すぎやまなおひろ	杉山直宏	固有一般
すぎやままこと	杉山誠	固有一般
すぎやまりきひろ	杉山力裕	固有一般
すぎやまれお	杉山伶央	固有一般
すぐりひろまさ	村主博正	固有一般
すげのたかのり	菅野孝憲	固有一般
すざききょうへい	須崎恭平	固有一般
すずなおき	鈴直樹	固有一般
すずかげんたろう	鈴鹿源太郎	固有一般
すずきあきと	鈴木暁登	固有一般
すずきあきと	鈴木章斗	固有一般
すずきあさひ	鈴木朝日	固有一般
すずきあやき	鈴木彩貴	固有一般
すずきいちろう	鈴木一朗	固有一般
すずきかいと	鈴木魁人	固有一般
すずきかいと	鈴木海音	固有一般
すずきかずひろ	鈴木和裕	固有一般
すずきかつひろ	鈴木勝大	固有一般
すずきかずみ	鈴木克美	固有一般
すずきくにとも	鈴木国友	固有一般
すずきくらのすけ	鈴木蔵之介	固有一般
すずきけいご	鈴木奎吾	固有一般
すずきけいた	鈴木啓太	固有一般
すずきけんしろう	鈴木拳士郎	固有一般
すずきけんじ	鈴木健児	固有一般
すずきけんた	鈴木健太	固有一般
すずきけんたろう	鈴木健太郎	固有一般
すずきこうじ	鈴木孝司	固有一般
すずきこうすけ	鈴木浩介	固有一般
すずきこうた	鈴木厚太	固有一般
すずきさとる	鈴木悟	固有一般
すずきざいおん	鈴木彩艶	固有一般
すずきしゅうと	鈴木修人	固有一般
すずきしゅん	鈴木俊	固有一般
すずきしゅんのすけ	鈴木駿之助	固有一般
すずきしゅんや	鈴木俊也	固有一般
すずきしょうた	鈴木将太	固有一般
すずきしょうた	鈴木翔大	固有一般
すずきしょうた	鈴木翔太	固有一般
すずきしょうと	鈴木翔登	固有一般
すずきしんご	鈴木慎吾	固有一般
すずきじゅん	鈴木惇	固有一般
すずきじゅん	鈴木潤	固有一般
すずきじゅん	鈴木淳	固有一般
すずきじゅんのすけ	鈴木淳之介	固有一般
すずきじゅんや	鈴木順也	固有一般
すずきじゅんや	鈴木準弥	固有一般
すずきそう	鈴木颯	固有一般
すずきたかあき	鈴木孝明	固有一般
すずきたかふみ	鈴木崇文	固有一般
すずきたかゆき	鈴木敬之	固有一般
すずきたかゆき	鈴木隆行	固有一般
すずきたけひと	鈴木健仁	固有一般
すずきたつや	鈴木達也	固有一般
すずきだいすけ	鈴木大輔	固有一般
すずきだいせい	鈴木大誠	固有一般
すずきだいち	鈴木大馳	固有一般
すずきつばさ	鈴木翼	固有一般
すずきといち	鈴木冬一	固有一般
すずきとくま	鈴木徳真	固有一般
すずきともき	鈴木智樹	固有一般
すずきともや	鈴木智也	固有一般
すずきともゆき	鈴木智幸	固有一般
すずきのぶたか	鈴木伸貴	固有一般
すずきのりお	鈴木規郎	固有一般
すずきはやた	鈴木颯太	固有一般
すずきはやと	鈴木隼人	固有一般
すずきはると	鈴木陽人	固有一般
すずきひでと	鈴木秀人	固有一般
すずきひなせ	鈴木陽成	固有一般
すずきふみや	鈴木郁也	固有一般
すずきふみや	鈴木史哉	固有一般
すずきぶるーの	鈴木 ブルーノ	固有一般
すずきまさのり	鈴木将方	固有一般
すずきまさはる	鈴木正治	固有一般
すずきまさひと	鈴木正人	固有一般
すずきまさや	鈴木将也	固有一般
すずきみずき	鈴木瑞生	固有一般
すずきむさし	鈴木武蔵	固有一般
すずきゆいと	鈴木唯人	固有一般
すずきゆうき	鈴木悠希	固有一般
すずきゆうき	鈴木雄貴	固有一般
すずきゆうすけ	鈴木祐輔	固有一般
すずきゆうた	鈴木悠太	固有一般
すずきゆうた	鈴木雄太	固有一般
すずきゆうと	鈴木雄斗	固有一般
すずきゆうま	鈴木優磨	固有一般
すずきよしかず	鈴木良和	固有一般
すずきよしたけ	鈴木喜丈	固有一般
すずきよしのり	鈴木義宜	固有一般
すずきりゅうが	鈴木隆雅	固有一般
すずきりゅうせい	鈴木琉世	固有一般
すずきりょうた	鈴木椋大	固有一般
すずきりょうた	鈴木涼汰	固有一般
すずきわだいぶらひーむ	鈴木輪太朗イブラヒーム	固有一般
すずむらたくや	鈴村拓也	固有一般
すだこうすけ	須田興輔	固有一般
すだよしまさ	須田芳正	固有一般
すだりゅうしん	須田龍心	固有一般
すていまんそたろう	ステイマンＪ草太郎	固有一般
すとうなおき	須藤直輝	固有一般
すとうわたる	須藤渉	固有一般
すどうたかふみ	須藤貴郁	固有一般
すどうだいすけ	須藤大輔	固有一般
すどうゆうすけ	須藤右介	固有一般
すなかわまこと	砂川誠	固有一般
すながわたいし	砂川太志	固有一般
すなだたくみ	砂田匠	固有一般
すなもりかずや	砂森和也	固有一般
すみけんしん	角健心	固有一般
すみこうしろう	角昂志郎	固有一般
すみこたろう	隅廣太郎	固有一般
すみせいが	鷲見星河	固有一般
すみらいむ	角来夢	固有一般
すみだしょう	住田将	固有一般
すみだたかひこ	住田貴彦	固有一般
すみながかける	住永翔	固有一般
すみのあいと	住野碧音	固有一般
すみのはるき	隅野遥喜	固有一般
すみよしじぇらにれしょーん	住吉ジェラニレショーン	固有一般
すわゆうだい	諏訪雄大	固有一般
すわぞのかずよし	諏訪園一吉	固有一般
すわまこせい	諏訪間幸成	固有一般
ずけやまいっしん	瑞慶山一真	固有一般
ずしこうしろう	圖師好至郎	固有一般
せいけそうた	清家颯太	固有一般
せいじたいが	清治大雅	固有一般
せいたなおや	清田奈央弥	固有一般
せいのともあき	清野智秋	固有一般
せがわかずき	瀬川和樹	固有一般
せがわまこと	瀬川誠	固有一般
せがわゆうすけ	瀬川祐輔	固有一般
せきかいと	関海斗	固有一般
せきけんたろう	関憲太郎	固有一般
せきこうじ	関浩二	固有一般
せきたかし	関貴史	固有一般
せきたかみち	関隆倫	固有一般
せきみつひろ	関光博	固有一般
せきゆうと	関祐斗	固有一般
せきりゅうせい	関龍聖	固有一般
せきがわいくま	関川郁万	固有一般
せきぐちかいしん	関口凱心	固有一般
せきぐちくんみつ	関口訓充	固有一般
せきぐちけいすけ	関口圭亮	固有一般
せきぐちじょう	関口丈	固有一般
せきぐちまさひろ	関口正大	固有一般
せきたひろし	関田寛士	固有一般
せきどけんじ	関戸健二	固有一般
せきねえいご	関根永悟	固有一般
せきねたかひろ	関根貴大	固有一般
せきねひろき	関根大輝	固有一般
せきのあいき	関野愛紀	固有一般
せきのきっぺい	関野喜平	固有一般
せきのげんや	関野元弥	固有一般
せきはらりょうが	関原凌河	固有一般
せきもとこういち	関本恒一	固有一般
せきやひかる	関谷輝	固有一般
せぐちたくや	瀬口拓弥	固有一般
せこあゆむ	瀬古歩夢	固有一般
せこかんじ	瀬古寛治	固有一般
せこたつき	瀬古樹	固有一般
せせひろと	世瀬啓人	固有一般
せそこせいや	瀬底正椰	固有一般
せっつはやと	摂津颯登	固有一般
せとたかゆき	瀬戸貴幸	固有一般
せとはるき	瀬戸春樹	固有一般
せとぐちなおと	瀬戸口脩人	固有一般
せぬままさかず	瀬沼正和	固有一般
せぬまゆうじ	瀬沼優司	固有一般
せのおなおや	妹尾直哉	固有一般
せのおりゅうすけ	妹尾隆佑	固有一般
せはたぎじょう	瀬畠義成	固有一般
せやまかずき	瀬山航生	固有一般
せらだけんいち	世良田顕一	固有一般
せりざわひゅう	芹澤飛勇	固有一般
せんごくれん	仙石廉	固有一般
せんざきかつや	先崎勝也	固有一般
せんだいがくと	仙臺岳斗	固有一般
せんとうけいや	仙頭啓矢	固有一般
せんばたいし	仙波大志	固有一般
せんぷくそうた	泉福創太	固有一般
そくわんすー	徐冠秀	固有一般
そとめたつみ	早乙女達海	固有一般
そうまじょう	相馬丞	固有一般
そうまたかひと	相馬崇人	固有一般
そうまなおき	相馬直樹	固有一般
そうまゆうき	相馬勇紀	固有一般
そえだたかし	添田隆司	固有一般
そがだいち	曽我大地	固有一般
そがはたひとし	曽ヶ端準	固有一般
そがべけいた	曽我部慶太	固有一般
そたかずあき	曽田一騎	固有一般
そだゆうし	曽田雄志	固有一般
そてつこうき	蘓鉄航生	固有一般
そのだゆたか	曽根田穣	固有一般
そのだしゅうた	其田秀太	固有一般
そのだしゅん	園田駿	固有一般
そのだしょうた	薗田尚大	固有一般
そのだじゅん	薗田淳	固有一般
そのだたくま	薗田卓馬	固有一般
そのだたくや	園田拓也	固有一般
そめのいつき	染野唯月	固有一般
そめやかずき	染矢一樹	固有一般
そめやけい	染谷奎	固有一般
そめやゆうた	染谷悠太	固有一般
そやとしかず	征矢智和	固有一般
そりまちかずき	反町一輝	固有一般
そりまちやすはる	反町康治	固有一般
そんしゅんこう	孫峻崗	固有一般
そんせいほう	宋勝鳳	固有一般
たいらさとし	平聡	固有一般
たいらせいたろう	平誠太朗	固有一般
たいらともひろ	平智広	固有一般
たおけいすけ	田尾佳祐	固有一般
たおはると	田尾日寿	固有一般
たかいかずま	高井和馬	固有一般
たかいこうた	高井幸大	固有一般
たかいわりゅうせい	高岩流星	固有一般
たかえれお	髙江麗央	固有一般
たかおりゅう	髙尾瑠	固有一般
たかおりゅうせい	髙尾流星	固有一般
たかおかようへい	高丘陽平	固有一般
たかきじゅんぺい	高木純平	固有一般
たかきなりた	高木成太	固有一般
たかぎあきと	髙木 彰人	固有一般
たかぎかずまさ	高木和正	固有一般
たかぎかずみち	高木和道	固有一般
たかぎけんじ	高木健旨	固有一般
たかぎしどう	髙木獅道	固有一般
たかぎしゅん	高木駿	固有一般
たかぎせん	高木践	固有一般
たかぎたかひろ	高木貴弘	固有一般
たかぎたくや	高木琢也	固有一般
たかぎだいすけ	高木大輔	固有一般
たかぎとしや	高木利弥	固有一般
たかぎとしゆき	高木俊幸	固有一般
たかぎゆうや	高木友也	固有一般
たかぎよしあき	高木善朗	固有一般
たかぎよしなり	高木義成	固有一般
たかぎしけんしん	髙岸憲伸	固有一般
たかぎわとおる	高木和徹	固有一般
たかくぼけんと	髙窪健人	固有一般
たかくわだいじろう	高桑大二朗	固有一般
たかさきこうき	髙崎弘輝	固有一般
たかさきてんしろう	高崎天史郎	固有一般
たかさきひろゆき	高崎寛之	固有一般
たかさきりき	高嵜理貴	固有一般
たかざわゆうや	髙澤優也	固有一般
たかしおはやせ	高塩隼生	固有一般
たかしまこうしろう	高島康四郎	固有一般
たかしましゅうや	高嶋修也	固有一般
たかすゆうだい	高須雄大	固有一般
たかすようへい	高須洋平	固有一般
たかすかさとみ	髙須賀惺峯	固有一般
たかせあきら	高瀬証	固有一般
たかせかずな	髙瀨和楠	固有一般
たかせたいせい	髙瀨太聖	固有一般
たかせたいち	高瀬太一	固有一般
たかせゆうこう	高瀬 優孝	固有一般
たかたじゅん	高田純	固有一般
たかたたいおう	高田大鳳	固有一般
たかだえいじ	高田栄二	固有一般
たかだせいや	高田聖也	固有一般
たかだそうた	髙田蒼太	固有一般
たかだそうや	髙田颯也	固有一般
たかだてつや	高田哲也	固有一般
たかだまさあき	高田昌明	固有一般
たかだやすのり	高田保則	固有一般
たかだりょうた	髙田椋汰	固有一般
たかちけいじ	髙地系治	固有一般
たかつかせいや	高塚星弥	固有一般
たかぬきたいえい	高貫太瑛	固有一般
たかのこうじ	高野光司	固有一般
たかのこうへい	高野耕平	固有一般
たかのしゅうや	髙野秀哉	固有一般
たかのなつき	高野捺貴	固有一般
たかのりょう	高野遼	固有一般
たかはぎようじろう	髙萩洋次郎	固有一般
たかはしいっせい	髙橋壱晟	固有一般
たかはしいっぺい	高橋一平	固有一般
たかはしかえで	髙橋楓	固有一般
たかはしかずき	高橋和希	固有一般
たかはしかずき	髙橋一輝	固有一般
たかはしけい	高橋佳	固有一般
たかはしけいご	高橋慶伍	固有一般
たかはしけんごう	高橋謙豪	固有一般
たかはしけんじ	髙橋健史	固有一般
たかはしけんじ	高橋健二	固有一般
たかはしげんいち	高橋厳一	固有一般
たかはしこうが	高橋昂雅	固有一般
たかはしこうだい	高橋昂大	固有一般
たかはしこうへい	高橋耕平	固有一般
たかはししいば	高橋思瓜芭	固有一般
たかはししゅうた	高橋周大	固有一般
たかはししゅんき	高橋峻希	固有一般
たかはししゅんた	高橋駿太	固有一般
たかはししょうへい	高橋祥平	固有一般
たかはししんいちろう	高橋真一郎	固有一般
たかはしじゅんや	高橋潤哉	固有一般
たかはしすばる	高橋昴	固有一般
たかはしそうや	高橋壮也	固有一般
たかはしたいよう	髙橋太陽	固有一般
たかはしたく	高橋拓	固有一般
たかはしたくや	高橋拓也	固有一般
たかはしただお	高橋忠男	固有一般
たかはしだいご	髙橋大悟	固有一般
たかはしだいすけ	高橋大輔	固有一般
たかはしとしき	髙橋利樹	固有一般
たかはしともや	高橋友矢	固有一般
たかはしなおき	高橋直樹	固有一般
たかはしなおき	高橋尚紀	固有一般
たかはしなおや	髙橋直也	固有一般
たかはしなおや	高橋直也	固有一般
たかはしなるき	髙橋成樹	固有一般
たかはしのりお	高橋範夫	固有一般
たかはしひかる	高橋輝	固有一般
たかはしひでと	高橋秀人	固有一般
たかはしひでのり	高橋秀典	固有一般
たかはしひろと	髙橋優仁	固有一般
たかはしひろゆき	高橋宏幸	固有一般
たかはしまさひろ	高橋昌大	固有一般
たかはしまなと	高橋真士	固有一般
たかはしゆう	高橋悠	固有一般
たかはしゆうしょう	高橋祐翔	固有一般
たかはしゆうじ	高橋祐治	固有一般
たかはしゆうた	髙橋勇太	固有一般
たかはしゆうたろう	高橋祐太郎	固有一般
たかはしゆうま	高橋悠馬	固有一般
たかはしゆたか	高橋泰	固有一般
たかはしゆづき	高橋唯月	固有一般
たかはしゆりや	高橋勇利也	固有一般
たかはしよしき	高橋義希	固有一般
たかはしよしき	髙橋馨希	固有一般
たかはしりお	高橋凛央	固有一般
たかはしりゅうた	髙橋隆大	固有一般
たかはしりゅうのすけ	高橋龍ノ介	固有一般
たかはしりょう	高橋亮	固有一般
たかはしりょう	高橋諒	固有一般
たかはしりょうた	高橋良太	固有一般
たかはたけいた	高畑奎汰	固有一般
たかはたともや	髙畑智也	固有一般
たかはらとしやす	髙原寿康	固有一般
たかはらなおひろ	高原直泰	固有一般
たかばやしゆうき	高林佑樹	固有一般
たかべあきら	高部聖	固有一般
たかまつだいき	高松大樹	固有一般
たかまつだいち	高松大智	固有一般
たかみけいた	高見啓太	固有一般
たかみねともき	高嶺朋樹	固有一般
たかもとのりふみ	高本詞史	固有一般
たかもとみきひろ	髙本幹大	固有一般
たかやすたかゆき	高安孝幸	固有一般
たかやすりょうすけ	高安亮介	固有一般
たかやなぎいっせい	髙柳一誠	固有一般
たかやなぎえいじろう	高柳英二郎	固有一般
たかやなぎこうへい	高柳昂平	固有一般
たかやなぎふみや	高柳郁弥	固有一般
たかやなぎまさよし	高柳昌賢	固有一般
たかやまかおる	高山薫	固有一般
たかやまようへい	高山洋平	固有一般
たかやまりょうじろう	高山椋二朗	固有一般
たかよししょうま	高吉正真	固有一般
たからきお	高良希生	固有一般
たがしらりょうた	田頭亮太	固有一般
たがみあんり	田上亜璃	固有一般
たがみだいち	田上大地	固有一般
たがわきょうすけ	田川亨介	固有一般
たがわともき	田川知樹	固有一般
たきゆうた	滝裕太	固有一般
たきざわくにひこ	滝澤邦彦	固有一般
たきざわしゅうへい	瀧澤修平	固有一般
たきざわだん	瀧澤暖	固有一般
たきざわてん	瀧澤天	固有一般
たきせけんたろう	滝瀬健太郎	固有一般
たきたもえと	瀧田萌人	固有一般
たきたゆうき	田北雄気	固有一般
たきみずれんたろう	瀧水蓮太郎	固有一般
たきもとはるひこ	滝本晴彦	固有一般
たきやりょう	瀧谷亮	固有一般
たくさがわたかし	田草川貴	固有一般
たくまこうよう	田熊航洋	固有一般
たぐちけいた	田口啓太	固有一般
たぐちけんた	田口絢大	固有一般
たぐちじゅんと	田口潤人	固有一般
たぐちたいし	田口泰士	固有一般
たぐちたつや	田口達也	固有一般
たぐちひじり	田口聖	固有一般
たぐちゆうや	田口裕也	固有一般
たぐちよしのり	田口禎則	固有一般
たけせいや	武星弥	固有一般
たけはやて	武颯	固有一般
たけいせいごう	武井成豪	固有一般
たけいたくや	武井択也	固有一般
たけいゆうま	武井邑馬	固有一般
たけうちあきら	竹内彬	固有一般
たけうちえいすけ	竹内瑛亮	固有一般
たけうちたかと	竹内崇人	固有一般
たけうちだい	武内大	固有一般
たけうちだいと	竹内大斗	固有一般
たけうちりゅうま	竹内琉真	固有一般
たけうちりょう	竹内涼	固有一般
たけうちりょうたろう	竹内諒太郎	固有一般
たけおかひろと	竹岡寛人	固有一般
たけおかゆうと	武岡優斗	固有一般
たけざわかずと	武沢一翔	固有一般
たけしげあきひこ	竹重安希彦	固有一般
たけしたともや	武下智哉	固有一般
たけしたれお	竹下玲王	固有一般
たけしまゆうじ	竹嶋裕二	固有一般
たけだあやと	武田絢都	固有一般
たけだえいじろう	武田英二郎	固有一般
たけだしょうへい	武田将平	固有一般
たけだじろう	武田治郎	固有一般
たけだたいち	武田太一	固有一般
たけだたくま	武田拓真	固有一般
たけだただし	竹田忠嗣	固有一般
たけだだい	武田大	固有一般
たけだなおたけ	武田直隆	固有一般
たけだぬぼひろ	武田修宏	固有一般
たけだぬぼひろ	武田亘弘	固有一般
たけだひであき	武田英明	固有一般
たけだひでとし	武田英寿	固有一般
たけだひろゆき	武田博行	固有一般
たけだゆうすけ	武田有祐	固有一般
たけだゆうせい	武田悠聖	固有一般
たけだようへい	武田洋平	固有一般
たけとみこうすけ	武富孝介	固有一般
たけなかこうき	竹中公基	固有一般
たけなかみのる	竹中穣	固有一般
たけののぞみ	竹野希	固有一般
たけはらきんや	竹原欣也	固有一般
たけべこうすけ	武部洸佑	固有一般
たけむらしゅんじ	竹村俊二	固有一般
たけむらよしや	竹村栄哉	固有一般
たけもとしょうた	竹本将太	固有一般
たけもとゆうひ	竹本雄飛	固有一般
たけもとよしゆき	竹元義幸	固有一般
たけやむつみ	竹谷睦	固有一般
たこもとのぶ	田光仁重	固有一般
たさかかずあき	田坂和昭	固有一般
たさかゆうすけ	田坂祐介	固有一般
たざわひろゆき	田沢浩之	固有一般
たざわゆうき	田澤勇気	固有一般
たしまりく	田島凌空	固有一般
たしろこう	田代紘	固有一般
たしろひろと	田代寛人	固有一般
たしろまさかず	田代真一	固有一般
たしろまさや	田代雅也	固有一般
たしろゆうぞう	田代有三	固有一般
たしろようすけ	田代 容輔	固有一般
たしろりゅうが	田代琉我	固有一般
たじましょうた	田島昇太	固有一般
たじまひろあき	田島宏晃	固有一般
たじりけん	田尻健	固有一般
たじりこうせい	田尻康晴	固有一般
たたらあつと	多々良敦斗	固有一般
ただこうや	多田亘冶	固有一般
ただたかゆき	多田高行	固有一般
ただだいすけ	多田大介	固有一般
ただゆうき	多田雄貴	固有一般
ただりょうすけ	夛田凌輔	固有一般
たてこうき	舘幸希	固有一般
たちかわこたろう	立川小太郎	固有一般
たちのしゅんすけ	舘野俊祐	固有一般
たちばなあきと	橘章斗	固有一般
たちばなあゆむ	立花歩夢	固有一般
たちばなかずき	橘一輝	固有一般
たちばなこうせい	立花康生	固有一般
たちばなはるき	立花春輝	固有一般
たちばなひびき	立花響	固有一般
たちばなだけんと	橘田健人	固有一般
たつたゆうご	立田悠悟	固有一般
たていしあすか	立石飛鳥	固有一般
たていしとものり	立石智紀	固有一般
たてだこうた	舘田晃太	固有一般
たどころりょう	田所諒	固有一般
たなかあお	田中碧	固有一般
たなかあとむ	田中亜土夢	固有一般
たなかかずき	田中和樹	固有一般
たなかかんた	田中勘太	固有一般
たなかきりと	田中輝里十	固有一般
たなかぎんじ	田中吟侍	固有一般
たなかけいた	田中恵太	固有一般
たなかけんご	田中謙吾	固有一般
たなかけんしん	田中堅清	固有一般
たなかけんじ	田中賢治	固有一般
たなかこうすけ	田中康介	固有一般
たなかこうたろう	田中洸太朗	固有一般
たなかこうへい	田中康平	固有一般
たなかさとし	田中聡	固有一般
たなかしゅうと	田中秀人	固有一般
たなかしゅん	田中舜	固有一般
たなかしゅんいち	田中俊一	固有一般
たなかしゅんた	田中駿汰	固有一般
たなかしょう	田中憧	固有一般
たなかしょう	田中翔	固有一般
たなかしょうま	田中彰馬	固有一般
たなかしんじ	田中真二	固有一般
たなかしんすけ	田中紳介	固有一般
たなかじげん	田中侍賢	固有一般
たなかじゅん	田中淳	固有一般
たなかじゅんぺい	田中純平	固有一般
たなかじゅんや	田中淳也	固有一般
たなかじゅんや	田中順也	固有一般
たなかそういち	田中奏一	固有一般
たなかそる	田中颯流	固有一般
たなかそら	田中想来	固有一般
たなかたいが	田中大雅	固有一般
たなかたかひろ	田中貴大	固有一般
たなかたつや	田中達也	固有一般
たなかだいすけ	田中大輔	固有一般
たなかてつや	田中哲也	固有一般
たなかてるかず	田中輝和	固有一般
たなかてるき	田中輝希	固有一般
たなかとうあ	田中叶碧	固有一般
たなかとしや	田中俊也	固有一般
たなかとしや	田中稔也	固有一般
たなかともひろ	田中智大	固有一般
たなかなおき	田中直基	固有一般
たなかななせ	田中七星	固有一般
たなかのぶたか	田中信孝	固有一般
たなかはやて	田中颯	固有一般
たなかはやと	田中隼人	固有一般
たなかはゆま	田中隼磨	固有一般
たなかぱうろじゅんいち	田中 パウロ淳一	固有一般
たなかひおら	田中陽己良	固有一般
たなかひでお	田中英雄	固有一般
たなかひろき	田中寛己	固有一般
たなかひろと	田中裕人	固有一般
たなかひろまさ	田中宏昌	固有一般
たなかひろむ	田中宏武	固有一般
たなかまこと	田中誠	固有一般
たなかゆうき	田中優毅	固有一般
たなかまるくすとぅーりお	田中 マルクス闘莉王	固有一般
たなかゆうき	田中雄輝	固有一般
たなかゆうすけ	田中裕介	固有一般
たなかゆうすけ	田中佑昌	固有一般
たなかゆうだい	田中雄大	固有一般
たなかゆうや	田中悠也	固有一般
たなかゆうや	田中優也	固有一般
たなかよしなが	田中慶延	固有一般
たなかりく	田中陸	固有一般
たなかりゅうしろう	田中龍志郎	固有一般
たなかわたる	田中渉	固有一般
たなだしん	棚田伸	固有一般
たなだはやて	棚田颯	固有一般
たなだりょう	棚田遼	固有一般
たなはしあきと	棚橋尭士	固有一般
たなはしゆうすけ	棚橋雄介	固有一般
たなべかずひこ	田辺和彦	固有一般
たなべけいすけ	田辺圭佑	固有一般
たなべこうへい	田邉光平	固有一般
たなべしゅうと	田邉秀斗	固有一般
たなべそたん	田邉草民	固有一般
たなべようた	田辺陽太	固有一般
たなべりょうた	田鍋陵太	固有一般
たにいぶき	谷聖己	固有一般
たにこうせい	谷晃生	固有一般
たにしゅんくん	谷俊勲	固有一般
たにしんいちろう	谷真一郎	固有一般
たにいけようへい	谷池洋平	固有一般
たにおこうや	谷尾昂也	固有一般
たにおたかひろ	谷尾隆博	固有一般
たにおかまさし	谷岡昌	固有一般
たにおくけんしろう	谷奥健四郎	固有一般
たにおくゆうさく	谷奥優作	固有一般
たにかわつよし	谷川烈	固有一般
たにがわしょうすけ	谷川尚翼	固有一般
たにがわゆうま	谷川勇磨	固有一般
たにぐちいさお	谷口功	固有一般
たにぐちかいと	谷口海斗	固有一般
たにぐちけい	谷口圭	固有一般
たにぐちけんぞう	谷口堅三	固有一般
たにぐちしょうご	谷口彰悟	固有一般
たにぐちともき	谷口智紀	固有一般
たにぐちひろと	谷口栄斗	固有一般
たにぐちひろゆき	谷口博之	固有一般
たにぐちゆうすけ	谷口裕介	固有一般
たにぐちりっせい	谷口璃成	固有一般
たにぐちりょうや	谷口遼弥	固有一般
たにだそしお	谷田壮志朗	固有一般
たにだれんと	谷田蓮都	固有一般
たにむらかいな	谷村海那	固有一般
たにむらけんいち	谷村憲一	固有一般
たにむらしゅん	谷村峻	固有一般
たにむらなおや	谷村尚哉	固有一般
たにもとくんぺい	谷本薫平	固有一般
たにもとしゅんすけ	谷本駿介	固有一般
たにもとそうたろう	谷本壮太朗	固有一般
たにもとゆうき	谷本雄紀	固有一般
たにやまゆうと	谷山湧人	固有一般
たねおかたかまさ	種岡岐将	固有一般
たねだはるひ	種田陽	固有一般
たねむらゆうじ	種村優志	固有一般
たのうえしんや	田ノ上信也	固有一般
たのうえだいち	田上大地	固有一般
たのうえゆう	田上裕	固有一般
たのべそう	田野辺創	固有一般
たはらゆうほ	田原悠帆	固有一般
たはらゆたか	田原豊	固有一般
たはられんと	田原廉登	固有一般
たばでぃえご	田場ディエゴ	固有一般
たばしせいや	田橋征也	固有一般
たばたあきひろ	田畑昭宏	固有一般
たばたあつろう	田畑篤郎	固有一般
たばたてるき	田畑輝樹	固有一般
たばたのぶしげ	田端信成	固有一般
たばたひでのり	田端秀規	固有一般
たばたりゅうせい	田端琉聖	固有一般
たばたりん	田畑麟	固有一般
たびらたつや	田平起也	固有一般
たぶちゆう	田渕佑	固有一般
たぶちりゅうじ	田渕 龍二	固有一般
たべいゆう	田部井悠	固有一般
たべいりょう	田部井涼	固有一般
たまいともや	玉井智也	固有一般
たまがわけんた	玉川健太	固有一般
たまがわゆう	玉川由	固有一般
たまきふみや	玉城史也	固有一般
たましろしゅんご	玉城峻吾	固有一般
たましろたいし	玉城大志	固有一般
たましろゆきや	玉城幸弥	固有一般
たまだけいじ	玉田圭司	固有一般
たまのじゅん	玉乃淳	固有一般
たまばやしむつみ	玉林睦実	固有一般
たまるとしき	田丸星輝	固有一般
たむかいたいき	田向泰輝	固有一般
たむらしょうた	田村翔汰	固有一般
たむらしょうた	田村翔太	固有一般
たむらそうき	田村蒼生	固有一般
たむらそうすけ	田村聡佑	固有一般
たむらつばさ	田村翼	固有一般
たむらともや	田村朋也	固有一般
たむらなおひろ	田村直弘	固有一般
たむらなおや	田村直也	固有一般
たむらはやと	田村勇人	固有一般
たむらまさたか	田村仁崇	固有一般
たむらゆう	田村友	固有一般
たむらゆうき	田村祐基	固有一般
たむらゆうぞう	田村雄三	固有一般
たむらりょうすけ	田村亮介	固有一般
ためだひろたか	為田大貴	固有一般
たもまさのり	賜正憲	固有一般
たもりだいき	田森大己	固有一般
たわらつみだこうた	俵積田晃太	固有一般
たんだいそうや	丹代爽弥	固有一般
たんのけんた	丹野研太	固有一般
だいけんじ	代健司	固有一般
だいとうあつむ	大當侑	固有一般
だいもとりゅうじ	大本竜司	固有一般
だていつき	舘樹	固有一般
だてみちひさ	伊達倫央	固有一般
だんざきりく	檀崎竜孔	固有一般
だんのせな	檀野世那	固有一般
ちあきたかのり	千明聖典	固有一般
ちくんしく	崔根植	固有一般
ちょいじょんはん	崔 正漢	固有一般
ちょいすんくく	崔 成國	固有一般
ちすんぐん	崔誠根	固有一般
ちさんよん	崔成勇	固有一般
ちだいしく	崔大植	固有一般
ちょえびょんぎる	崔炳吉	固有一般
ちねいく	崔文植	固有一般
ちよんす	崔龍洙	固有一般
ちかいしてっぺい	近石哲平	固有一般
ちくこうすけ	知久航介	固有一般
ちしまとおる	千島徹	固有一般
ちだかいと	千田海人	固有一般
ちだけいと	千田奎斗	固有一般
ちだゆうき	千田悠貴	固有一般
ちねんけい	知念慶	固有一般
ちねんてつや	知念哲矢	固有一般
ちねんゆうたろう	知念雄太朗	固有一般
ちのとしき	千野俊樹	固有一般
ちばおさむ	千葉修	固有一般
ちばかずひこ	千葉和彦	固有一般
ちばかんた	千葉寛汰	固有一般
ちばしんや	千葉真也	固有一般
ちばそうた	千葉奏汰	固有一般
ちばたかひと	千葉貴仁	固有一般
ちばたける	千葉武	固有一般
ちばとらじ	千葉虎士	固有一般
ちばなおき	千葉直樹	固有一般
ちばやすのぶ	千葉泰伸	固有一般
ちぶかづき	千布一輝	固有一般
ちゃじほ	車 智鎬	固有一般
ちゃどんぐん	車東訓	固有一般
ちゃじまゆうすけ	茶島雄介	固有一般
ちゃのたかゆき	茶野隆行	固有一般
ちゅうごまさき	中後雅喜	固有一般
ちょうぉんひ	趙源熙	固有一般
ちょどんぎょん	趙東建	固有一般
ちょびょんくく	曺 秉局	固有一般
ちょみんう	趙民宇	固有一般
ちょよんちょる	曺 永哲	固有一般
ちゃんあおりん	張奥林	固有一般
ちょうきじぇ	曺 貴裁	固有一般
ちゃんしゅう	張帥	固有一般
ちょさんぐわん	趙晟桓	固有一般
ちゃうてんし	趙天賜	固有一般
じょんさんへ	全山海	固有一般
じょんせうんひゅん	鄭 昇炫	固有一般
じょんしょんぐん	丁成勳	固有一般
ちょんてせ	鄭大世	固有一般
じょんふんせうん	鄭 薫聖	固有一般
ちょんよんで	鄭容臺	固有一般
ちよたんだみつる	千代反田充	固有一般
ちんゆんか	陳運華	固有一般
つかがわこうき	塚川孝輝	固有一般
つかだしょうご	塚田翔悟	固有一般
つかだゆうすけ	塚田裕介	固有一般
つかのまさき	塚野真樹	固有一般
つかはらてっしん	塚原輝	固有一般
つかもとあきまさ	塚本明正	固有一般
つかもとたいし	塚本泰史	固有一般
つかもとだい	塚元大	固有一般
つかもとはやと	塚本颯	固有一般
つかもとひでき	塚本秀樹	固有一般
つくいけいすけ	津久井佳祐	固有一般
つくいたくみ	津久井匠海	固有一般
つくたいっとう	營田一燈	固有一般
つくだけんすけ	佃賢典	固有一般
つけぎゆうや	附木雄也	固有一般
つしまかつひろ	津島克洋	固有一般
つしまみつとし	津島三敏	固有一般
つじしゅうご	辻周吾	固有一般
つじそうた	辻創太	固有一般
つじまさお	辻正男	固有一般
つじいきょうへい	辻井恭平	固有一般
つじおしんじ	辻尾真二	固有一般
つじおかゆうま	辻岡佑真	固有一般
つじのこうだい	辻野航大	固有一般
つじもとしげき	辻本茂輝	固有一般
つたはやて	蔦颯	固有一般
つだかずき	津田和樹	固有一般
つだたくま	津田琢磨	固有一般
つだともひろ	津田知宏	固有一般
つちだてつや	土田哲也	固有一般
つちだひさし	土田尚史	固有一般
つちはしこうや	土橋公哉	固有一般
つちはしまさき	土橋正樹	固有一般
つちやかいと	土屋櫂大	固有一般
つちやたくみ	土屋巧	固有一般
つちやゆきお	土屋征夫	固有一般
つついのりあき	筒井紀章	固有一般
つつみけんご	堤健吾	固有一般
つつみこういち	堤耕一	固有一般
つつみこんな	堤晃波	固有一般
つつみしゅんすけ	堤俊輔	固有一般
つつみせいじ	堤聖司	固有一般
つづきりょうた	都築龍太	固有一般
つなしまゆうと	綱島悠斗	固有一般
つなだたいし	綱田大志	固有一般
つなみさとし	都並敏史	固有一般
つなみゆうた	都並優太	固有一般
つねまつとものり	恒松伴典	固有一般
つねもとけいご	常本佳吾	固有一般
つねやすみお	常安澪	固有一般
つのだたくみ	角田拓海	固有一般
つのだよしかぜ	角田恵風	固有一般
つのだりょうたろう	角田涼太朗	固有一般
つはじつき	津覇実樹	固有一般
つばきなおき	椿直起	固有一般
つぼいかずま	坪井一真	固有一般
つぼいきよしろう	坪井清志郎	固有一般
つぼいけいすけ	坪井慶介	固有一般
つぼいゆうや	坪井湧也	固有一般
つぼうちしゅうすけ	坪内秀介	固有一般
つぼかわひろゆき	坪川潤之	固有一般
つぼごらいき	坪郷来紀	固有一般
つまがりいっせい	津曲一誠	固有一般
つみたけいすけ	積田景介	固有一般
つむらかずき	津村和希	固有一般
つゆきかずと	筑城和人	固有一般
つるいりせい	鶴井李成	固有一般
つるたかいと	鶴田海人	固有一般
つるたこせい	鶴田剛生	固有一般
つるたたつや	鶴田達也	固有一般
つるたみちひろ	鶴田道弘	固有一般
つるのたいき	鶴野太貴	固有一般
つるのれいじゅ	鶴野怜樹	固有一般
つるまきけんと	弦巻健人	固有一般
つるみとしたか	鶴見聡貴	固有一般
つるみともよし	鶴見智美	固有一般
てしまかずき	手島和希	固有一般
てしまひで	手嶋秀	固有一般
てつとひろし	鐡戸裕史	固有一般
てづかこうへい	手塚康平	固有一般
てづかなおき	手塚直樹	固有一般
てづかりゅうせい	手塚琉惺	固有一般
てらおりょうた	寺尾遼太	固有一般
てらおかまさひろ	寺岡真弘	固有一般
てらかどりく	寺門陸	固有一般
てらかわよしと	寺川能人	固有一般
てらさかしょうご	寺阪尚悟	固有一般
てらさわゆうた	寺沢優太	固有一般
てらしたとうわ	寺下翔和	固有一般
てらしまはるひ	寺島はるひ	固有一般
てらだしゅうへい	寺田周平	固有一般
てらだしんいち	寺田紳一	固有一般
てらだたけし	寺田武史	固有一般
てらだまさふみ	寺田匡史	固有一般
てらだようすけ	寺田洋介	固有一般
てらぬましもん	寺沼星文	固有一般
てらまえこうた	寺前光太	固有一般
てらむらこうへい	寺村浩平	固有一般
てらやまつばさ	寺山翼	固有一般
てるいあつし	照井篤	固有一般
てるやまはやと	照山颯人	固有一般
でぃびっどそんじゅんまーかす	ディビッドソン純マーカス	固有一般
でいしょうたろう	出井正太郎	固有一般
でおかだいき	出岡大輝	固有一般
とうしぃた	藤海太	固有一般
とうごうつばさ	東郷翼	固有一般
とじようすけ	田路耀介	固有一般
とうじょうあつき	東條敦輝	固有一般
とぼうはるが	當房悠雅	固有一般
とうましな	當真蒔音	固有一般
とうまたけふみ	當間建文	固有一般
とうまはやて	當麻颯	固有一般
とうやさとき	東家聡樹	固有一般
とうやましょうじ	唐山翔自	固有一般
とうりりよん	桃李理永	固有一般
とおのだいや	遠野大弥	固有一般
とうやまゆうき	遠山悠希	固有一般
とうやまゆうと	遠山湧斗	固有一般
とがしけいまん	富樫敬真	固有一般
とがしこういち	冨樫剛一	固有一般
とがしゆうた	富樫佑太	固有一般
とがわけんた	戸川健太	固有一般
ときおかひろまさ	時岡宏昌	固有一般
ときさきゆう	時崎悠	固有一般
ときさきるい	時崎塁	固有一般
ときざわさとし	常澤聡	固有一般
ときしじん	時志仁	固有一般
ときたこうへい	土岐田洸平	固有一般
ときたしゅうさく	鴇田周作	固有一般
ときだまさと	常田克人	固有一般
ときひさしょうご	時久省吾	固有一般
ときわきょうた	常盤亨太	固有一般
ときわさとし	常盤聡	固有一般
とくいはるま	得居大真	固有一般
とくしげけんた	徳重健太	固有一般
とくしげたかあき	徳重隆明	固有一般
とくたけまさゆき	徳武正之	固有一般
とくだほまれ	徳田誉	固有一般
とくだゆうま	徳田佑真	固有一般
とくどめじん	徳留尽	固有一般
とくながこうたろう	徳永晃太郎	固有一般
とくながゆうだい	徳永裕大	固有一般
とくながゆうへい	徳永悠平	固有一般
とくのそうき	得能草生	固有一般
とくもとかなた	徳本奏太	固有一般
とくもとゆうへい	徳元悠平	固有一般
とくらけん	都倉賢	固有一般
とくらけんいちろう	戸倉健一郎	固有一般
とさりくう	土佐陸翼	固有一般
とざきまさき	登崎雅貴	固有一般
としだゆうせい	土信田悠生	固有一般
としまあきら	戸島章	固有一般
としまさちろう	戸嶋祥郎	固有一般
とだいぶき	戸田伊吹	固有一般
とだかずゆき	戸田和幸	固有一般
とだたかよし	戸田賢良	固有一般
とだひろと	戸田大翔	固有一般
とだみつひろ	戸田光洋	固有一般
とだかひろき	戸高弘貴	固有一般
とつかてつや	戸塚哲也	固有一般
とねいっせい	戸根一誓	固有一般
とねりょうすけ	刀根亮輔	固有一般
とねるい	利根瑠偉	固有一般
とのいけだいすけ	外池大亮	固有一般
とばとしまさ	鳥羽俊正	固有一般
とびたゆうだい	飛田裕大	固有一般
とみいえいじ	富井英司	固有一般
とみいだいき	富居大樹	固有一般
とみかわゆうと	富川勇斗	固有一般
とみくだかずま	冨久田和真	固有一般
とみさかゆうじん	冨坂優仁	固有一般
とみざわせいたろう	富澤清太郎	固有一般
とみざわまさや	富澤雅也	固有一般
とみしまひとし	冨嶋均	固有一般
とみたこうへい	冨田康平	固有一般
とみたしんご	富田晋伍	固有一般
とみたしんや	冨田晋矢	固有一般
とみただいすけ	冨田大介	固有一般
とみたやすひと	富田康仁	固有一般
とみどころゆう	富所悠	固有一般
とみながにじなな	冨永虹七	固有一般
とみながひであき	富永英明	固有一般
とみながやすひろ	富永康博	固有一般
とみなりしんじ	冨成慎司	固有一般
とみやおが	冨谷央雅	固有一般
とみやすたけひろ	冨安健洋	固有一般
とみやまたかみつ	富山貴光	固有一般
とみやまたつゆき	冨山達行	固有一般
とむらそういちろう	戸村総一郎	固有一般
ともざわごうき	友澤剛気	固有一般
ともざわたかき	友澤貴気	固有一般
ともちかとしあき	友近聡朗	固有一般
ともよせじあん	友寄慈安	固有一般
ともりきいち	友利貴一	固有一般
ともりたいよう	友利太虹	固有一般
ともりゆうしろう	友利祐志朗	固有一般
とよまけいた	外山佳大	固有一般
とよまりょう	外山凌	固有一般
とよかわゆうた	豊川雄太	固有一般
とよしまかいと	豊島海斗	固有一般
とよしまゆうさく	豊嶋邑作	固有一般
とよだあゆむ	豊田歩	固有一般
とよだこうき	豊田晃大	固有一般
とよだしょうた	豊田将大	固有一般
とよだやすひろ	豊田泰広	固有一般
とよだようへい	豊田陽平	固有一般
とりいひろと	鳥居大人	固有一般
とりいづかのぶひと	鳥居塚伸人	固有一般
とりうみこうじ	鳥海晃司	固有一般
とりかいゆうや	鳥養祐矢	固有一般
とりかいよしき	鳥海芳樹	固有一般
とりがいりょうへい	鳥飼椋平	固有一般
どいかんた	土肥幹太	固有一般
どいこき	土井紅貴	固有一般
どいこうへい	土井康平	固有一般
どいしゅうた	土居柊太	固有一般
どいしょうま	土居聖真	固有一般
どいともゆき	土井智之	固有一般
どいひでと	土井秀徒	固有一般
どいよういち	土肥洋一	固有一般
どいよしと	土井嘉人	固有一般
どいよしのり	土居義典	固有一般
どいりょうた	土井良太	固有一般
どあんゆう	堂安憂	固有一般
どあんりつ	堂安律	固有一般
どがきりゅういち	堂柿龍一	固有一般
どはなかずき	堂鼻起暉	固有一般
どもとひろと	道本大飛	固有一般
どもりかつとし	堂森勝利	固有一般
どえんしゅうへい	土遠修平	固有一般
どだてけんと	土館賢人	固有一般
どばしひろゆき	土橋宏由樹	固有一般
どひこうだい	土肥航大	固有一般
なそうす	羅 誠洙	固有一般
ないとうけいすけ	内藤圭佑	固有一般
ないとうけんた	内藤健太	固有一般
ないとうじゅん	内藤潤	固有一般
ないとうともやす	内藤友康	固有一般
ないとうなおき	内藤直樹	固有一般
ないとうなるゆき	内藤就行	固有一般
ないとうのぶひろ	内藤修弘	固有一般
ないとうやまと	内藤大和	固有一般
ないとうようへい	内藤洋平	固有一般
なかいえいと	中井英人	固有一般
なかいかなで	中井奏	固有一般
なかいしょうご	中井昇吾	固有一般
なかいたかと	中井崇仁	固有一般
なかいだいき	中井大翔	固有一般
なかいよしき	中井義樹	固有一般
なかおあつし	中尾篤人	固有一般
なかおこうき	中尾洸稀	固有一般
なかおこうじ	中尾康二	固有一般
なかおこうたろう	中尾幸太郎	固有一般
なかおつよし	中尾剛	固有一般
なかがきりゅういちろう	中垣龍一朗	固有一般
なかがわかざき	中川風希	固有一般
なかがわそう	中川創	固有一般
なかがわてるひと	仲川輝人	固有一般
なかがわはぐむ	中川育	固有一般
なかがわひろと	中川裕仁	固有一般
なかがわひろと	中川寛斗	固有一般
なかがわまさひこ	中河昌彦	固有一般
なかがわゆうじ	中川雄二	固有一般
なかがわようすけ	中川洋介	固有一般
なかがわよしかつ	中川義貴	固有一般
なかごみまさゆき	中込正行	固有一般
なかさかゆうや	中坂勇哉	固有一般
なかさきはやと	中崎颯人	固有一般
なかざとこういち	中里晃一	固有一般
なかざとこうじ	中里宏司	固有一般
なかざとたかひろ	中里崇宏	固有一般
なかざとゆうま	仲里勇真	固有一般
なかざわかいり	中澤海吏	固有一般
なかざわそうた	中澤聡太	固有一般
なかざわともひで	中澤友秀	固有一般
なかざわゆうじ	中澤佑二	固有一般
なかしおだいき	中塩大貴	固有一般
なかしまきりと	中島聖翔	固有一般
なかしまけんせい	中島賢星	固有一般
なかしまこうへい	中島康平	固有一般
なかしまたいか	中島大嘉	固有一般
なかしまたいき	中島大貴	固有一般
なかしまたけし	中島豪	固有一般
なかしまひろみ	中島宏海	固有一般
なかしまゆうき	中島裕希	固有一般
なかしまゆうだい	中嶋雄大	固有一般
なかしまようのすけ	中島洋之介	固有一般
なかじまあつき	中島惇希	固有一般
なかじまこうじ	中島浩司	固有一般
なかじましゅん	中島舜	固有一般
なかじましゅんいち	中島俊一	固有一般
なかじましょうや	中島翔哉	固有一般
なかじまじょう	中嶋譲	固有一般
なかじまたいが	中島大雅	固有一般
なかじまたかのり	中島崇典	固有一般
なかじまたくま	中島拓真	固有一般
なかじまちかぜ	中島千風	固有一般
なかじまもとひこ	中島元彦	固有一般
なかじまよたろう	中島洋太朗	固有一般
なかじまよしき	仲島義貴	固有一般
なかじまれいじ	中島礼司	固有一般
なかずみかい	中角海音	固有一般
なかたいちぞう	中田一三	固有一般
なかたけんたろう	中田健太郎	固有一般
なかたこうじ	中田浩二	固有一般
なかたしゅんき	中田舜貴	固有一般
なかたひでとし	中田英寿	固有一般
なかたゆうだい	中田湧大	固有一般
なかたようすけ	中田洋介	固有一般
なかたにきよし	中谷喜代志	固有一般
なかたにしんのすけ	中谷進之介	固有一般
なかたにちょうた	中谷超太	固有一般
なかたにゆうすけ	中谷勇介	固有一般
なかだけんじ	仲田建二	固有一般
なかだじゅのん	中田樹音	固有一般
なかだひろき	中田大貴	固有一般
なかだゆうき	中田祐暉	固有一般
なかだようへい	中田洋平	固有一般
なかだいしょうた	中台翔太	固有一般
なかだちたくと	仲達拓斗	固有一般
なかつぼやすた	中坪優汰	固有一般
なかつるしょうご	中津留奨吾	固有一般
なかどいみのる	中土井稔	固有一般
なかにしえいすけ	中西永輔	固有一般
なかにしけんと	中西健人	固有一般
なかにしてつお	中西哲生	固有一般
なかにしてつや	中西哲也	固有一般
なかにしともや	中西倫也	固有一般
なかにしのりまさ	中西規真	固有一般
なかのかつや	中野克哉	固有一般
なかのけい	中野圭	固有一般
なかのけいいちろう	中野圭一郎	固有一般
なかのけいた	中野桂太	固有一般
なかのこうへい	中埜航平	固有一般
なかのこじろう	中野小次郎	固有一般
なかのしゅうと	中野就斗	固有一般
なかのしんや	中野伸哉	固有一般
なかのせいや	中野誠也	固有一般
なかのそうた	中野颯大	固有一般
なかのたける	仲野丈翔	固有一般
なかのだい	中野大	固有一般
なかのようじ	中野洋司	固有一般
なかのまさおみ	中野雅臣	固有一般
なかのゆうた	中野裕太	固有一般
なかのゆうや	中野優也	固有一般
なかのよしひろ	中野嘉大	固有一般
なかのりゅうと	中野龍斗	固有一般
なかのりゅうま	中野瑠馬	固有一般
なかはらしゅうと	中原秀人	固有一般
なかはらしょうご	中原彰吾	固有一般
なかはらそら	中原蒼空	固有一般
なかはらたかゆき	中原貴之	固有一般
なかはらだん	中原弾	固有一般
なかはらひかる	中原輝	固有一般
なかはらゆうせい	中原優生	固有一般
なかはらいだいすけ	中払大介	固有一般
なかばやしひろつぐ	中林洋次	固有一般
なかばやしまさと	中林優友	固有一般
なかまはやと	仲間隼斗	固有一般
なかまちこうすけ	中町公祐	固有一般
なかまるしんたろう	仲丸慎太郎	固有一般
なかみけいや	中美慶哉	固有一般
なかむらあつたか	中村充孝	固有一般
なかむらありゅう	中村亜龍	固有一般
なかむらかいと	中村海渡	固有一般
なかむらきょうが	仲村京雅	固有一般
なかむらきよし	中村樹佳	固有一般
なかむらけいた	中村慶太	固有一般
なかむらけいと	中村敬斗	固有一般
なかむらけんご	中村憲剛	固有一般
なかむらけんと	中村健人	固有一般
なかむらこうき	中村宏輝	固有一般
なかむらこうすけ	中村航輔	固有一般
なかむらこうせい	中村幸聖	固有一般
なかむらごう	中村豪	固有一般
なかむらしゅん	中村駿	固有一般
なかむらしゅんすけ	中村俊輔	固有一般
なかむらしゅんた	中村駿太	固有一般
なかむらしん	中村伸	固有一般
なかむらじゅんや	中村隼也	固有一般
なかむらじろう	中村仁郎	固有一般
なかむらせいご	中村成吾	固有一般
なかむらたいすけ	中村太亮	固有一般
なかむらたいち	中村太一	固有一般
なかむらたくみ	中村拓海	固有一般
なかむらたすく	中村将	固有一般
なかむらただし	中村忠	固有一般
なかむらだいき	中村太記	固有一般
なかむらつばさ	中村翼	固有一般
なかむらとうや	中村桐耶	固有一般
なかむらとしき	中村俊貴	固有一般
なかむらなおし	中村直志	固有一般
なかむらはやと	中村隼	固有一般
なかむらひでゆき	中村英之	固有一般
なかむらひろひと	中村洋仁	固有一般
なかむらふみあき	中村文昭	固有一般
なかむらほくと	中村北斗	固有一般
なかむらほたか	中村帆高	固有一般
なかむらまなぶ	中村学	固有一般
なかむらゆうき	中村祐輝	固有一般
なかむらゆうすけ	中村友亮	固有一般
なかむらゆうま	中村優真	固有一般
なかむらゆうや	中村祐哉	固有一般
なかむらゆうや	中村祐也	固有一般
なかむらゆら	仲村優良	固有一般
なかむらよしき	中村香紀	固有一般
なかむらよしろう	中村祥朗	固有一般
なかむらりゅうが	中村龍雅	固有一般
なかむらりゅうが	中村琉雅	固有一般
なかむらりゅうせい	中村琉聖	固有一般
なかむらりょう	中村亮	固有一般
なかむらりょう	中村涼	固有一般
なかむらりょうた	中村亮太	固有一般
なかむらりょうたろう	中村亮太朗	固有一般
なかもとかずし	中本一志	固有一般
なかもりだいすけ	中森大介	固有一般
なかやまあつき	中山温樹	固有一般
なかやまかいほ	中山開帆	固有一般
なかやまかずや	中山和弥	固有一般
なかやまかつひろ	中山克広	固有一般
なかやまげんき	中山元気	固有一般
なかやまさとし	中山悟志	固有一般
なかやまのぼる	中山昇	固有一般
なかやまひろき	中山博貴	固有一般
なかやままさし	中山雅史	固有一般
なかやままさと	中山仁斗	固有一般
なかやまゆうき	中山雄希	固有一般
なかやまゆうた	中山雄太	固有一般
なかやまゆうと	中山雄登	固有一般
なかやまりく	中山陸	固有一般
なかよしゆうじ	中吉裕司	固有一般
ながいあつし	永井篤志	固有一般
ながいえいじ	永井英次	固有一般
ながいかずま	長井一真	固有一般
ながいけんご	永井堅梧	固有一般
ながいけんすけ	永井謙佑	固有一般
ながいしおん	永井心温	固有一般
ながいしゅんた	永井俊太	固有一般
ながいそうた	永井颯太	固有一般
ながいたつなり	永井建成	固有一般
ながいひでき	永井秀樹	固有一般
ながいひびき	長井響	固有一般
ながいゆういちろう	永井雄一郎	固有一般
ながいりょう	永井龍	固有一般
ながいしたくみ	永石拓海	固有一般
ながいしやまと	永石大和	固有一般
ながえゆうま	長江裕真	固有一般
ながおこうた	長尾航太	固有一般
ながおたいせい	長尾泰成	固有一般
ながおゆうと	長尾優斗	固有一般
ながかわかんた	永川寛太	固有一般
ながきりょうた	永木亮太	固有一般
ながくらはやて	長倉颯	固有一般
ながくらもとき	長倉幹樹	固有一般
ながさかゆうと	永坂勇人	固有一般
ながさかよしき	長坂恭樹	固有一般
ながさとげんき	永里源気	固有一般
ながさわかずき	長澤和輝	固有一般
ながさわしばたふぁり	長澤シバタファリ	固有一般
ながさわしゅん	長沢駿	固有一般
ながさわしうぁたふぁり	長澤シヴァタファリ	固有一般
ながさわたくみ	長澤卓己	固有一般
ながさわたくや	長澤拓哉	固有一般
ながさわてつ	長澤徹	固有一般
ながさわみかぜ	永澤海風	固有一般
ながさわみずき	長澤瑞紀	固有一般
ながさわゆうや	長沢祐弥	固有一般
ながさわりょうすけ	永澤竜亮	固有一般
ながしまあきひろ	永島昭浩	固有一般
ながしまこうだい	長島滉大	固有一般
ながしまゆうし	永島悠史	固有一般
ながせはると	永瀬温大	固有一般
ながたかずま	永田一真	固有一般
ながたかんた	永田貫太	固有一般
ながたこうたろう	永田滉太朗	固有一般
ながたこうだい	永田倖大	固有一般
ながたたかし	永田崇	固有一般
ながたたくや	永田拓也	固有一般
ながたみつる	永田充	固有一般
ながたりゅうじ	永田隆二	固有一般
ながたりょうた	永田亮太	固有一般
ながつかあさひ	長塚陽	固有一般
ながとかつや	永戸勝也	固有一般
ながとあゆむ	永藤歩	固有一般
ながとみゆうや	永冨裕也	固有一般
ながともこういちろう	長友耕一郎	固有一般
ながともやまと	長友大和	固有一般
ながともゆうと	長友佑都	固有一般
ながぬまよいち	長沼洋一	固有一般
ながのさとし	長野聡	固有一般
ながのしゅうと	永野修都	固有一般
ながのしょうき	長野星輝	固有一般
ながのゆうだい	永野雄大	固有一般
ながはしやすひろ	長橋康弘	固有一般
ながはたゆうき	永畑祐樹	固有一般
ながはまてる	永濱天琉	固有一般
ながみつこうき	長光晃輝	固有一般
ながみねひろのり	長峯宏範	固有一般
ながみねゆうと	長峰祐斗	固有一般
ながやすかんた	永易柑太	固有一般
ながやまかずや	長山一也	固有一般
ながやまくにお	永山邦夫	固有一般
ながよしたくま	永芳卓磨	固有一般
ながれはたいき	流羽汰綺	固有一般
なぎらともかず	柳楽智和	固有一般
なぐらたくみ	名倉巧	固有一般
なごしんたろう	名古新太郎	固有一般
なごしえいこう	名越瑛恆	固有一般
なすしんや	奈須伸也	固有一般
なすじんゆう	那須甚有	固有一般
なすそうすけ	那須奏輔	固有一般
なすだいすけ	那須大亮	固有一般
なすてっぺい	奈須哲平	固有一般
なすかわまさひろ	那須川将大	固有一般
なだはるき	灘遥希	固有一般
なずかよしひろ	名塚善寛	固有一般
なつめゆうき	棗佑喜	固有一般
なとりあつし	名取篤	固有一般
ななきだかい	七木田快	固有一般
ななみかずさ	名波上総	固有一般
ななみひろし	名波浩	固有一般
ななむれあおと	七牟禮蒼杜	固有一般
なべしまはるむ	鍋島暖歩	固有一般
なべたあつし	鍋田純志	固有一般
なべたあとむ	鍋田亜人夢	固有一般
なまずたたいよう	鯰田太陽	固有一般
なもとらい	波本頼	固有一般
ならたつき	奈良竜樹	固有一般
ならやすよし	奈良安剛	固有一般
ならさかたくみ	奈良坂巧	固有一般
ならざきこうせい	楢崎光成	固有一般
ならざきせいごう	楢﨑正剛	固有一般
ならざきひろし	奈良﨑寛	固有一般
ならはしあきら	名良橋晃	固有一般
ならはしたくま	名良橋拓真	固有一般
ならはらよしき	楢原慶輝	固有一般
ならばやしひろき	奈良林寛紀	固有一般
ならわゆうた	奈良輪雄太	固有一般
なりさわゆうあん	成澤夢行	固有一般
なりたきょうすけ	成田恭輔	固有一般
なりたりょうすけ	成田諒介	固有一般
なりやまゆうじ	成山裕治	固有一般
なるおなおき	鳴尾直軌	固有一般
なるおかしょう	成岡翔	固有一般
なるおかひかる	成岡輝瑠	固有一般
なるせしゅんぺい	成瀬竣平	固有一般
なるみいつく	鳴海慈	固有一般
なんばひろあき	難波宏明	固有一般
なんぶけんぞう	南部健造	固有一般
にいしゅんすけ	新居俊介	固有一般
にいかわおりべ	新川織部	固有一般
にいざとりょう	新里涼	固有一般
にいぜきせいや	新関成弥	固有一般
にいむらやすひこ	新村泰彦	固有一般
にいやましょうち	新井山祥智	固有一般
にうかわあゆみ	牲川歩見	固有一般
にかいどうせいや	二階堂正哉	固有一般
にしこうすけ	西晃佑	固有一般
にしたける	西洸瑠	固有一般
にしだいご	西大伍	固有一般
にしのりひろ	西紀寛	固有一般
にしひろのり	西弘則	固有一般
にしまさはる	西政治	固有一般
にしようすけ	西洋祐	固有一般
にしりんせい	西凜誓	固有一般
にしいたいよう	西井太陽	固有一般
にしおひびき	西尾響	固有一般
にしおりゅうや	西尾隆矢	固有一般
にしおかけんた	西岡謙太	固有一般
にしおかせいち	西岡政智	固有一般
にしおかたいし	西岡大志	固有一般
にしおかだいき	西岡大輝	固有一般
にしかたゆたろう	西方優太郎	固有一般
にしかわあゆむ	西川歩	固有一般
にしかわこんのすけ	西川幸之介	固有一般
にしかわしゅうご	西川周吾	固有一般
にしかわしゅうさく	西川周作	固有一般
にしかわしゅんいちろう	西川駿一郎	固有一般
にしかわしょうご	西河翔吾	固有一般
にしかわしんや	西川慎也	固有一般
にしかわじゅん	西川潤	固有一般
にしかわひろと	西川大翔	固有一般
にしかわゆうだい	西川優大	固有一般
にしかわよしひで	西川吉英	固有一般
にしがやたかゆき	西ヶ谷隆之	固有一般
にしくぼしゅんすけ	西久保駿介	固有一般
にしぐちりょう	西口諒	固有一般
にしざかとうわ	西坂斗和	固有一般
にしざわあきのり	西澤明訓	固有一般
にしざわけんた	西澤健太	固有一般
にしざわじゅんじ	西澤淳二	固有一般
にしざわよしや	西澤代志也	固有一般
にしじまひろゆき	西嶋弘之	固有一般
にしじまゆうや	西嶋有矢	固有一般
にしじまりゅうと	西島隆斗	固有一般
にしたにまさや	西谷正也	固有一般
にしたにりょう	西谷亮	固有一般
にしだかいと	西田快斗	固有一般
にしだかずと	西田一翔	固有一般
にしだごう	西田剛	固有一般
にしだつばさ	西田翼	固有一般
にしだはると	西田春斗	固有一般
にしだまさや	西田将也	固有一般
にしだめぐむ	西田恵	固有一般
にしだゆうすけ	西田勇祐	固有一般
にしだゆうた	西田優太	固有一般
にしだよしひろ	西田吉洋	固有一般
にしどうひさとし	西堂久俊	固有一般
にしのこうへい	西野晃平	固有一般
にしのしょうた	西野奨太	固有一般
にしのたいよう	西野太陽	固有一般
にしのたかはる	西野貴治	固有一般
にしのつとむ	西野努	固有一般
にしのまこと	西野誠	固有一般
にしのやすまさ	西野泰正	固有一般
にしのうえはやと	西埜植颯斗	固有一般
にしはらこうた	西原広太	固有一般
にしはらたかし	西原誉志	固有一般
にしはらともき	西原源樹	固有一般
にしはられお	西原怜央	固有一般
にしばやしなおき	西林直輝	固有一般
にしべようへい	西部洋平	固有一般
にしみはるき	西見斗輝	固有一般
にしむらいおり	西村伊織	固有一般
にしむらかいひ	西村海陽	固有一般
にしむらかつき	西村活輝	固有一般
にしむらがく	西村岳	固有一般
にしむらけいすけ	西村慧祐	固有一般
にしむらこうじ	西村弘司	固有一般
にしむらしょう	西村翔	固有一般
にしむらすばる	西村昴	固有一般
にしむらたくま	西村拓真	固有一般
にしむらたくろう	西村卓朗	固有一般
にしむらはるき	西村遥己	固有一般
にしむらひでき	西村英樹	固有一般
にしむらやすふみ	西村恭史	固有一般
にしむらようへい	西村洋平	固有一般
にしむらりょう	西村涼	固有一般
にしむらりょうま	西村竜馬	固有一般
にしむられん	西村蓮音	固有一般
にしむろりゅうき	西室隆規	固有一般
にしもとたかのぶ	西本卓申	固有一般
にしもとたつひろ	西本竜洋	固有一般
にしもとまさたか	西本雅崇	固有一般
にしもりなおと	西森脩斗	固有一般
にしもりまさあき	西森正明	固有一般
にしもりゆうと	西森悠斗	固有一般
にしやかずき	西谷和希	固有一般
にしやけんと	西矢健人	固有一般
にしやゆうき	西谷優希	固有一般
にしやましゅんた	西山峻太	固有一般
にしやまそうた	西山草汰	固有一般
にしやまたいが	西山大雅	固有一般
にしやまたかひさ	西山貴永	固有一般
にしやまたくみ	西山拓実	固有一般
にしやまてっぺい	西山哲平	固有一般
にしやまゆうすけ	西山雄介	固有一般
にしわきてつや	西脇徹也	固有一般
にしわきりょうへい	西脇良平	固有一般
にたどりこうた	似鳥康太	固有一般
にったうみ	新田羽海	固有一般
にったこうせい	新田洸成	固有一般
にっただいすけ	新田大介	固有一般
にったりお	二田理央	固有一般
にとまさし	二戸将	固有一般
にのみやかずき	二宮和輝	固有一般
にのみやじよう	二ノ宮慈洋	固有一般
にのみやたくむ	仁宮拓夢	固有一般
にのみやはやて	二宮颯	固有一般
にのみやひろし	二宮浩	固有一般
にぱーどりーすひかる	ニパードリース光	固有一般
にへいつばさ	二瓶翼	固有一般
にわかずや	丹羽一陽	固有一般
にわしおん	丹羽詩温	固有一般
にわたくみ	丹羽匠	固有一般
にわだいき	丹羽大輝	固有一般
にわりゅうへい	丹羽竜平	固有一般
ぬきまさと	貫真郷	固有一般
ぬきなこせい	貫名航世	固有一般
ぬくいはやと	温井駿斗	固有一般
ぬのべたかのり	布部陽功	固有一般
ぬまだいき	沼大希	固有一般
ぬまたけいご	沼田圭悟	固有一般
ぬまたこうせい	沼田航征	固有一般
ぬまたすかい	沼田皇海	固有一般
ぬまたたかや	沼田駿也	固有一般
ぬりしりょう	塗師亮	固有一般
ねかどひろき	根角裕基	固有一般
ねぎこうき	根木洸希	固有一般
ねこたつや	根子達也	固有一般
ねじまりょうた	子島諒大	固有一般
ねじめしんご	根占真伍	固有一般
ねびきけんすけ	根引謙介	固有一般
ねもとけいすけ	根本圭輔	固有一般
ねもとこたろう	根本鼓太郎	固有一般
ねもとゆういち	根本裕一	固有一般
ねもとりょう	根本凌	固有一般
ねもとりょうすけ	根本亮助	固有一般
ねやましょうご	根山翔伍	固有一般
のじゅん	盧廷潤	固有一般
のいちごう	乃一悟生	固有一般
のがいとしゅん	野垣内俊	固有一般
のがみたくや	野上拓哉	固有一般
のがみゆうき	野上結貴	固有一般
のがみりゅうせい	野上琉成	固有一般
のぐちこうじ	野口幸司	固有一般
のぐちそうた	野口颯汰	固有一般
のぐちたつひこ	野口竜彦	固有一般
のぐちひろし	野口裕司	固有一般
のぐちりょうた	野口遼太	固有一般
のぐちれの	埜口怜乃	固有一般
のぐちわたる	野口航	固有一般
のざきけいた	野崎桂太	固有一般
のざきまさや	野崎雅也	固有一般
のざきようすけ	野崎陽介	固有一般
のざわけんいち	野澤健一	固有一般
のざわたいしぶらんどん	野澤大志ブランドン	固有一般
のざわたくや	野沢拓也	固有一般
のざわひでゆき	野澤英之	固有一般
のざわようすけ	野澤洋輔	固有一般
のざわりく	野澤陸	固有一般
のざわれおん	野澤零温	固有一般
のじまりょう	野嶋良	固有一般
のずえさとる	野末学	固有一般
のせりゅうせい	野瀬龍世	固有一般
のだあいと	野田愛斗	固有一般
のだあきひろ	野田明弘	固有一般
のだきょうへい	野田恭平	固有一般
のだこうじ	野田紘史	固有一般
のださとる	野田知	固有一般
のだしんぺい	野田秦平	固有一般
のだたつき	野田樹	固有一般
のだゆうき	野田裕喜	固有一般
のだひろと	野田大翔	固有一般
のだりゅうのすけ	野田隆之介	固有一般
のだけじゅんや	野嶽惇也	固有一般
のだけひろや	野嶽寛也	固有一般
のつまさきよ	野津真聖	固有一般
のつだがくと	野津田岳人	固有一般
のとまさひと	能登正人	固有一般
ののしたしょうじ	埜下荘司	固有一般
ののむらたかと	野々村鷹人	固有一般
ののむらよしかず	野々村芳和	固有一般
のはらけんた	野原健太	固有一般
のべゆうた	延祐太	固有一般
のぼりおけんとく	登尾顕徳	固有一般
のぼりさかのぶひろ	登坂信裕	固有一般
のぼりざときょうへい	登里享平	固有一般
のみやまひでき	野見山秀樹	固有一般
のむらてんま	野村天真	固有一般
のむらとしあき	野村俊瑛	固有一般
のむらなおき	野村直輝	固有一般
のむらまさたか	野村政孝	固有一般
のむらゆうき	野村祐暉	固有一般
のむらゆうと	野村勇仁	固有一般
のむらりつき	野村吏希	固有一般
のもとやすたか	野本泰崇	固有一般
のもとやすひろ	野本安啓	固有一般
のよりかずや	野寄和哉	固有一般
はせきしゅう	河錫舟	固有一般
はかまたゆうたろう	袴田裕太郎	固有一般
はがあさひ	芳賀日陽	固有一般
はがひろのぶ	芳賀博信	固有一般
はぎのこだい	萩野滉大	固有一般
はぎのひであき	萩野英明	固有一般
はぎはらしんや	萩原慎也	固有一般
はぎはらたつろう	萩原達郎	固有一般
はぎむらしげのり	萩村滋則	固有一般
はぎもとまさき	萩元雅樹	固有一般
はぎわらひろたく	萩原洪拓	固有一般
はずらもとひびき	櫨本響祈	固有一般
はしうちゆうや	橋内優也	固有一般
はしうちりょうま	橋内竜真	固有一般
はしおかだいき	橋岡大樹	固有一般
はしがきとこういち	橋垣戸光一	固有一般
はしぐちかいいち	橋口開一	固有一般
はしぐちたくや	橋口拓哉	固有一般
はしぐちまさる	橋口勝	固有一般
はしぐちりきや	橋口力也	固有一般
はしださとし	橋田聡司	固有一般
はしづめゆうき	橋爪勇樹	固有一般
はしばしょうき	橋場尚貴	固有一般
はしむらゆうた	橋村祐太	固有一般
はしむらりゅうじょせふ	橋村龍ジョセフ	固有一般
はしもときょうすけ	橋本恭輔	固有一般
はしもとけいご	橋本啓吾	固有一般
はしもとけんいち	橋本研一	固有一般
はしもとけんと	橋本健人	固有一般
はしもとけんと	橋本拳人	固有一般
はしもとこうじ	橋本晃司	固有一般
はしもとしゅん	橋本峻	固有一般
はしもとじょう	橋本丈	固有一般
はしもとすぐる	橋本卓	固有一般
はしもとそあら	橋本空新	固有一般
はしもとたくと	橋本拓門	固有一般
はしもとたくみ	橋本巧	固有一般
はしもととしき	橋本俊樹	固有一般
はしもとはやと	橋本早十	固有一般
はしもとひでお	橋本英郎	固有一般
はしもとまさと	橋本真人	固有一般
はしもとゆうき	橋本裕貴	固有一般
はしもとゆうじ	橋本雄二	固有一般
はしもとりく	橋本陸	固有一般
はしもとりくと	橋本陸斗	固有一般
はしもとわたる	橋本和	固有一般
はしらたにこういち	柱谷幸一	固有一般
はしらたにてつじ	柱谷哲二	固有一般
はじとしあき	羽地登志晃	固有一般
はすかわそうだい	蓮川壮大	固有一般
はすかわゆうだい	蓮川雄大	固有一般
はすぬましょうた	蓮沼翔太	固有一般
はすみこうせい	羽角康生	固有一般
はすみともひろ	蓮見知弘	固有一般
はせがわあきと	長谷川晶飛	固有一般
はせがわあーりあじゃすーる	長谷川アーリアジャスール	固有一般
はせがわけんた	長谷川健太	固有一般
はせがわこう	長谷川洸	固有一般
はせがわこうき	長谷川光基	固有一般
はせがわたいち	長谷川太一	固有一般
はせがわたくみ	長谷川巧	固有一般
はせがわたつや	長谷川竜也	固有一般
はせがわたろう	長谷川太郎	固有一般
はせがわつむぐ	長谷川紡	固有一般
はせがわとおる	長谷川徹	固有一般
はせがわとよき	長谷川豊喜	固有一般
はせがわはやと	長谷川隼	固有一般
はせがわひろかず	長谷川博一	固有一般
はせがわみつる	長谷川満	固有一般
はせがわもとき	長谷川元希	固有一般
はせがわゆう	長谷川悠	固有一般
はせがわゆうじ	長谷川雄志	固有一般
はせがわゆうすけ	長谷川雄介	固有一般
はせがわゆと	長谷川夢叶	固有一般
はせがわよしゆき	長谷川祥之	固有一般
はせがわりょう	長谷川諒	固有一般
はせがわりょう	長谷川凌	固有一般
はせべあやと	長谷部彩翔	固有一般
はせべしげとし	長谷部茂利	固有一般
はせべまこと	長谷部誠	固有一般
はたじゅんき	畑潤基	固有一般
はたたいが	畑大雅	固有一般
はたまさき	畑真暉	固有一般
はたみのる	畑実	固有一般
はたよしひと	畑嘉人	固有一般
はたおひろと	畑尾大翔	固有一般
はたぞえはやと	畑添隼人	固有一般
はただなおき	畑田真輝	固有一般
はたてしんや	旗手真也	固有一般
はたてれお	旗手怜央	固有一般
はたなかしんのすけ	畠中槙之輔	固有一般
はたなかまきと	畑中槙人	固有一般
はたなかゆうき	畠中佑樹	固有一般
はたなかゆうしろう	畠中勇士朗	固有一般
はたのごう	波多野豪	固有一般
はたのたかのり	幡野貴紀	固有一般
はたのひろし	波夛野寛	固有一般
はたのゆうま	畑野優真	固有一般
はたのりょうた	畑野遼太	固有一般
はたもとときお	畑本時央	固有一般
はたやませな	畑山聖那	固有一般
はだいっぺい	羽田一平	固有一般
はだけいすけ	羽田敬介	固有一般
はだけんじ	秦賢二	固有一般
はだのせいりゅう	羽田野成琉	固有一般
はだのそうし	波多野崇史	固有一般
はっくぼはやて	八久保颯	固有一般
はちすかこうじ	蜂須賀孝治	固有一般
はっかくだいち	八角大智	固有一般
はっかくつよし	八角剛史	固有一般
はつたしんや	初田真也	固有一般
はったなおき	八田直樹	固有一般
はったんだこうへい	八反田康平	固有一般
はっとりかずき	服部一輝	固有一般
はっとりこうた	服部公太	固有一般
はっとりこうた	服部航大	固有一般
はっとりこうへい	服部康平	固有一般
はっとりこうへい	服部航平	固有一般
はっとりたいき	服部大樹	固有一般
はっとりとしひろ	服部年宏	固有一般
はっとりひろき	服部浩紀	固有一般
はっぽれお	八方伶央	固有一般
はつせりょう	初瀬亮	固有一般
はとやすひろ	波戸康広	固有一般
はないしょう	花井聖	固有一般
はなだちから	花田力	固有一般
はなだゆきおみ	花田倖臣	固有一般
はたどじん	端戸仁	固有一般
はなふさみのる	花房稔	固有一般
はなやまえいじ	花山英二	固有一般
はにゅうなおたけ	羽生直剛	固有一般
はねだけんじ	羽田憲司	固有一般
はねだけんと	羽田健人	固有一般
はばたこうき	羽畑公貴	固有一般
はまたいよう	濱大耀	固有一般
はまたくみ	濱託巳	固有一般
はまおかかずひさ	濱岡和久	固有一般
はまかわはると	濵川遥斗	固有一般
はまぐちこうせい	濱口功聖	固有一般
はまぐちそうた	濱口草太	固有一般
はまさきしき	濱崎史揮	固有一般
はまさきたくま	浜崎拓磨	固有一般
はましたあきら	浜下瑛	固有一般
はまだかつひろ	濱田克大	固有一般
はまだけんしょう	濱田健正	固有一般
はまだこたろう	濱田心太朗	固有一般
はまだたけし	濱田武	固有一般
はまだたろう	濵田太郎	固有一般
はまだみずき	濱田水輝	固有一般
はまなまお	濱名真央	固有一般
はまのゆうき	濵野勇気	固有一般
はむよんじゅん	咸 泳俊	固有一般
はやかわじゅんぺい	早川隼平	固有一般
はやかわともき	早川友基	固有一般
はやかわとものぶ	早川知伸	固有一般
はやかわふみや	早川史哉	固有一般
はやかわよしき	早川嘉紀	固有一般
はやさかつばさ	早坂翼	固有一般
はやさかゆうき	早坂勇希	固有一般
はやさかゆうし	早坂優志	固有一般
はやさかりゅうのすけ	早坂龍之介	固有一般
はやさかりょうた	早坂良太	固有一般
はやしあきひろ	林彰洋	固有一般
はやしかずあき	林一章	固有一般
はやしかずき	林一輝	固有一般
はやしかんた	林莞太	固有一般
はやしけいすけ	林佳祐	固有一般
はやしけんご	林賢吾	固有一般
はやしけんたろう	林健太郎	固有一般
はやしこうき	林航輝	固有一般
はやしこたろう	林幸多郎	固有一般
はやしこうへい	林晃平	固有一般
はやしさとる	林慧	固有一般
はやししょうご	林昇吾	固有一般
はやししょうた	林祥太	固有一般
はやししょうたろう	林祥太郎	固有一般
はやしそう	林壮	固有一般
はやしそたろう	林奏太朗	固有一般
はやしそら	林碧良	固有一般
はやしたくと	林卓人	固有一般
はやしたけのり	林丈統	固有一般
はやしたけひろ	林威宏	固有一般
はやしだいち	林大地	固有一般
はやしともや	林友哉	固有一般
はやしなおき	林尚輝	固有一般
はやしひろゆき	林祐征	固有一般
はやしまさみち	林誠道	固有一般
はやしみずき	林瑞輝	固有一般
はやしゆうすけ	林勇介	固有一般
はやしようへい	林容平	固有一般
はやしりくや	林陸也	固有一般
はやしりょうへい	林陵平	固有一般
はやしたかいと	林田魁斗	固有一般
はやしたこうや	林田滉也	固有一般
はやしたともひこ	林田友彦	固有一般
はやしたりゅうすけ	林田隆介	固有一般
はやまごう	端山豪	固有一般
はやましんのすけ	葉山新之輔	固有一般
はやまたくみ	羽山拓巳	固有一般
はやみしゅうへい	速水修平	固有一般
はらかずき	原一樹	固有一般
はらかずき	原一貴	固有一般
はらたいち	原大智	固有一般
はらたくや	原拓也	固有一般
はらてるき	原輝綺	固有一般
はらなおき	原直生	固有一般
はらのぶき	原信生	固有一般
はらぶらいあんいけちゅく	原ブライアンイケチュク	固有一般
はらみこと	原尊	固有一般
はらゆうたろう	原裕太郎	固有一般
はらりゅうせい	原龍生	固有一般
はらりゅうた	原竜太	固有一般
はらいかわしょうご	原井川昇吾	固有一般
はらかわりき	原川力	固有一般
はらぐちげんき	原口元気	固有一般
はらぐちたくと	原口拓人	固有一般
はらぐちゆうじろう	原口祐次郎	固有一般
はらさきまさと	原崎政人	固有一般
はらざきはやて	原崎颯	固有一般
はらだかんた	原田幹太	固有一般
はらだがく	原田岳	固有一般
はらだけいすけ	原田圭輔	固有一般
はらだこうき	原田虹輝	固有一般
はらだこうすけ	原田紘介	固有一般
はらだしんたろう	原田慎太郎	固有一般
はらだたいが	原田大雅	固有一般
はらだたく	原田拓	固有一般
はらだたけお	原田武男	固有一般
はらだなおき	原田直樹	固有一般
はらだひろき	原田拓季	固有一般
はらだゆうすけ	原田祐輔	固有一般
はらだよしのぶ	原田欽庸	固有一般
はらだわたる	原田亘	固有一般
はらやまかいり	原山海里	固有一般
はりたにたけあき	針谷岳晃	固有一般
はるなりゅうせい	春名竜聖	固有一般
はるやまみさき	晴山岬	固有一般
はれまきたくみ	晴柀匠弥	固有一般
はんじぇみん	韓在民	固有一般
はんちゃんじゅ	韓昌柱	固有一般
はんほご	韓浩康	固有一般
はんよんぎ	韓勇岐	固有一般
はんよんたえ	韓勇太	固有一般
はんざわひかる	半澤光琉	固有一般
はんだこうや	半田航也	固有一般
はんだたけし	半田武嗣	固有一般
はんだゆうき	半田優希	固有一般
はんだりく	半田陸	固有一般
はんやようすけ	半谷陽介	固有一般
ばばかずひろ	馬場一博	固有一般
ばばけんじ	馬場賢治	固有一般
ばばせいや	馬場晴也	固有一般
ばばたくみ	馬場琢未	固有一般
ばばたくみ	馬場卓未	固有一般
ばばまさひろ	馬場将大	固有一般
ばばゆうた	馬場憂太	固有一般
ばばゆう	馬場悠	固有一般
ばらだあきみ	茨田陽生	固有一般
ばんぐーながんでかしふ	バングーナガンデ佳史扶	固有一般
ばんだいひろき	萬代宏樹	固有一般
ばんどりゅうじ	播戸竜二	固有一般
ぱくいるぎゅ	朴一圭	固有一般
ぱくぎどん	朴基棟	固有一般
ぱくくんは	朴建夏	固有一般
ぱくじゅんきょん	朴俊慶	固有一般
ぱくじょんす	朴庭秀	固有一般
ぱくじんす	朴鎭琇	固有一般
ぱくせうり	朴昇利	固有一般
ぱくじせい	朴智星	固有一般
ぱくじゅそん	朴柱成	固有一般
ぱくじょんじん	朴宗眞	固有一般
ぱくよんご	朴永浩	固有一般
ぱくりき	朴利基	固有一般
ひがこうへい	比嘉厚平	固有一般
ひがまさき	比嘉将貴	固有一般
ひがゆうさく	比嘉雄作	固有一般
ひがゆうすけ	比嘉祐介	固有一般
ひがりょうと	比嘉諒人	固有一般
ひがしかつとし	東克俊	固有一般
ひがしけいご	東慶悟	固有一般
ひがしこういち	東幸一	固有一般
ひがしこじろう	東胡次郎	固有一般
ひがししゅん	東駿	固有一般
ひがししゅんき	東俊希	固有一般
ひがしじゅんや	東隼也	固有一般
ひがしじょん	東ジョン	固有一般
ひがしりゅうのすけ	東龍之介	固有一般
ひがしれんた	東廉太	固有一般
ひがしかわよしのり	東川昌典	固有一般
ひがしぐちまさあき	東口順昭	固有一般
ひがしでそうた	東出壮太	固有一般
ひがしのこうたろう	東野広太郎	固有一般
ひがしやまたつき	東山達稀	固有一般
ひきだゆうと	疋田優人	固有一般
ひきちゆうや	曵地裕哉	固有一般
ひきちゆうや	挽地祐哉	固有一般
ひぐちかける	樋口叶	固有一般
ひぐちけん	樋口堅	固有一般
ひぐちだいき	樋口大輝	固有一般
ひぐちともゆき	樋口知行	固有一般
ひぐちひろき	樋口寛規	固有一般
ひぐちゆうた	樋口雄太	固有一般
ひぐちようた	樋口耀大	固有一般
ひぐちりんと	樋口凛人	固有一般
ひさしまりゅうい	久島隆維	固有一般
ひさとみけん	久富賢	固有一般
ひさどみりょうすけ	久富良輔	固有一般
ひさながたつのり	久永辰徳	固有一般
ひだんさとし	飛弾暁	固有一般
ひだかけいた	日髙慶太	固有一般
ひだかたくま	日高拓磨	固有一般
ひだかともき	日高智樹	固有一般
ひだかともや	日高智也	固有一般
ひだかまさる	日高大	固有一般
ひだかみつき	日髙光揮	固有一般
ひとみたくや	人見拓哉	固有一般
ひのいっしゅ	日野壱柊	固有一般
ひのしょうた	日野翔太	固有一般
ひのすぐる	日野優	固有一般
ひのそら	日野晴天	固有一般
ひめだこうだい	姫田耕大	固有一般
ひめのこうりゅう	姫野晃竜	固有一般
ひめのそら	姫野青空	固有一般
ひめのゆうや	姫野宥弥	固有一般
ひゃくたけよしなり	百武義成	固有一般
ひゃくだまなと	百田真登	固有一般
ひやまゆうき	檜山勇樹	固有一般
ひょうどうあきひろ	兵働昭弘	固有一般
ひょうどうけんと	兵藤健斗	固有一般
ひょうどうしんごう	兵藤慎剛	固有一般
ひょんりお	玄理吾	固有一般
ひらしゅうと	平秀斗	固有一般
ひらいしゅんすけ	平井駿助	固有一般
ひらいしょうき	平井将生	固有一般
ひらいしんたろう	平井晋太郎	固有一般
ひらいなおひと	平井直人	固有一般
ひらいりゅうへい	平井龍兵	固有一般
ひらいしけんた	平石健太	固有一般
ひらいしなおと	平石直人	固有一般
ひらいでりょう	平出涼	固有一般
ひらおけんしろう	平尾拳士朗	固有一般
ひらおしゅうと	平尾柊人	固有一般
ひらおそう	平尾壮	固有一般
ひらおとしき	平尾駿輝	固有一般
ひらおかたいよう	平岡大陽	固有一般
ひらおかたくま	平岡卓磨	固有一般
ひらおかたくみ	平岡拓望​​	固有一般
ひらおかたすく	平岡翼	固有一般
ひらおかなおき	平岡直起	固有一般
ひらおかひろあき	平岡宏章	固有一般
ひらおかまさひで	平岡将豪	固有一般
ひらおかやすなり	平岡靖成	固有一般
ひらおかやすひろ	平岡康裕	固有一般
ひらかわけんと	平川絢大	固有一般
ひらかわげんき	平川元樹	固有一般
ひらかわたくと	平川拓斗	固有一般
ひらかわただあき	平川忠亮	固有一般
ひらかわひろし	平川弘	固有一般
ひらかわゆう	平河悠	固有一般
ひらかわれい	平川怜	固有一般
ひらがそら	平賀大空	固有一般
ひらきよしき	平木良樹	固有一般
ひらさわけんすけ	平澤健介	固有一般
ひらさわたくみ	平澤拓巳	固有一般
ひらしげりゅういち	平繁龍一	固有一般
ひらしまたかし	平島崇	固有一般
ひらせだい	平瀬大	固有一般
ひらせともゆき	平瀬智行	固有一般
ひらたかいと	平田海斗	固有一般
ひらたけい	平田圭	固有一般
ひらたけんいちろう	平田拳一朗	固有一般
ひらたけんと	平田健斗	固有一般
ひらたしゅんすけ	平田駿佑	固有一般
ひらたたけき	平田武暉	固有一般
ひらたとしひで	平田俊英	固有一般
ひらつかじろう	平塚次郎	固有一般
ひらつかじん	平墳迅	固有一般
ひらつかゆうと	平塚悠知	固有一般
ひらとたいき	平戸太貴	固有一般
ひらのあおい	平野碧	固有一般
ひらのかい	平野甲斐	固有一般
ひらのたかし	平野孝	固有一般
ひらのゆういち	平野佑一	固有一般
ひらはらりゅうき	平原隆暉	固有一般
ひらばやしきよひろ	平林輝良寛	固有一般
ひらまともかず	平間智和	固有一般
ひらまなおみち	平間直道	固有一般
ひらまつこうき	平松功輝	固有一般
ひらまつこうたろう	平松孝汰朗	固有一般
ひらまつこうへい	平松康平	固有一般
ひらまつしゅう	平松宗	固有一般
ひらまつしょう	平松昇	固有一般
ひらまつだいし	平松大志	固有一般
ひらまつりょうたろう	平松遼太郎	固有一般
ひらまつわたる	平松航	固有一般
ひらもとかずき	平本一樹	固有一般
ひらもとたいすけ	平本大介	固有一般
ひらやましゅん	平山駿	固有一般
ひらやまそうた	平山相太	固有一般
ひらやまとものり	平山智規	固有一般
ひらやままさる	平山大	固有一般
ひろいとものぶ	廣井友信	固有一般
ひろいらんど	廣井蘭人	固有一般
ひろいしそうた	広石宗大	固有一般
ひろおかむつき	廣岡睦樹	固有一般
ひろきゆうま	廣木雄磨	固有一般
ひろすえりく	廣末陸	固有一般
ひろせおさむ	広瀬治	固有一般
ひろせけんた	広瀬健太	固有一般
ひろせこうじ	廣瀬浩二	固有一般
ひろせともやす	廣瀬智靖	固有一般
ひろせともゆき	廣瀬智行	固有一般
ひろせりくと	広瀬陸斗	固有一般
ひろたこうめい	廣田公明	固有一般
ひろたりゅうじ	廣田 隆治	固有一般
ひろながゆうじ	廣長優志	固有一般
ひろながりゅうき	廣永琉樹	固有一般
ひろながりょうたろう	廣永遼太郎	固有一般
ひろながれお	廣永獅旺	固有一般
ひろにわひかる	広庭輝	固有一般
ひろのこういち	広野耕一	固有一般
ひろはたしゅんた	廣畑俊汰	固有一般
ひろやまのぞみ	廣山望	固有一般
ぴーだーせんよこん	ピーダーセン世穏	固有一般
ほわんじんせい	黄辰成	固有一般
ふぉんすんみん	黄 順旻	固有一般
ほわんそんす	黄誠秀	固有一般
ほわんさんぐん	黄善洪	固有一般
ほわんたいじゅん	黄大俊	固有一般
ほわんてそん	黄大城	固有一般
ほわんがくじゅん	黄学淳	固有一般
ふぁんてぃーにあきら	ファンティーニ燦	固有一般
ふえまさと	笛真人	固有一般
ふかいかずき	深井一希	固有一般
ふかいけんじ	深井堅仁	固有一般
ふかいしゅうへい	深井脩平	固有一般
ふかいまさき	深井正樹	固有一般
ふかいゆうき	深井祐希	固有一般
ふかがわだいすけ	深川大輔	固有一般
ふかがわともたか	深川友貴	固有一般
ふかざわだいき	深澤大輝	固有一般
ふかざわまさひろ	深澤仁博	固有一般
ふかざわゆうた	深澤佑太	固有一般
ふかざわりく	深澤莉久	固有一般
ふかせはると	深瀬陽斗	固有一般
ふかつこうた	深津康太	固有一般
ふかほりしゅんぺい	深堀隼平	固有一般
ふかみこうき	深見光貴	固有一般
ふかみなとそういちろう	深港壮一郎	固有一般
ふかみやまさのり	深宮祐徳	固有一般
ふかやけいすけ	深谷圭佑	固有一般
ふかやゆうき	深谷友基	固有一般
ふくいおおじろう	福井大次郎	固有一般
ふくいかずき	福井和樹	固有一般
ふくいこうき	福井光輝	固有一般
ふくいたいち	福井太智	固有一般
ふくいまさと	福井理人	固有一般
ふくいゆうと	福井悠人	固有一般
ふくいりおん	福井凜音	固有一般
ふくいりょうじ	福井諒司	固有一般
ふくいれおなるどあきら	福井レオナルド明	固有一般
ふくおうただよ	福王忠世	固有一般
ふくおかしょうた	福岡将太	固有一般
ふくおかしんぺい	福岡慎平	固有一般
ふくざきりょうせい	福崎伶青	固有一般
ふくしげりょういち	福重良一	固有一般
ふくしまさとし	福島聡士	固有一般
ふくしましんた	福島新太	固有一般
ふくしまだいち	福島大地	固有一般
ふくしまはやと	福島隼斗	固有一般
ふくしまはるき	福島春樹	固有一般
ふくしまひろし	福嶋洋	固有一般
ふくしまりゅうや	福島立也	固有一般
ふくしまりゅうや	福島竜弥	固有一般
ふくしまりょう	福島遼	固有一般
ふくたあきと	福田晃斗	固有一般
ふくたひょうま	福田彪馬	固有一般
ふくたむく	福田武玖	固有一般
ふくたあいお	福田愛大	固有一般
ふくたけんじ	福田健二	固有一般
ふくたけんすけ	福田健介	固有一般
ふくたけんと	福田健人	固有一般
ふくたしゅんすけ	福田俊介	固有一般
ふくたしゅんた	福田旬汰	固有一般
ふくたしょう	福田翔生	固有一般
ふくたしんのすけ	福田心之助	固有一般
ふくたともや	福田友也	固有一般
ふくたまさひろ	福田正博	固有一般
ふくたみくと	福田望久斗	固有一般
ふくたやすひろ	福田恭大	固有一般
ふくたゆうや	福田湧矢	固有一般
ふくどめけんご	福留健吾	固有一般
ふくどめりょう	福留亮	固有一般
ふくながやすし	福永泰	固有一般
ふくながりょうけい	福永涼敬	固有一般
ふくにしたかし	福西崇史	固有一般
ふくばとき	福場時	固有一般
ふくみつたかき	福満隆貴	固有一般
ふくむらたかゆき	福村貴幸	固有一般
ふくもとともや	福元友哉	固有一般
ふくもとなおよし	福本尚純	固有一般
ふくもとゆう	福本悠	固有一般
ふくもとようへい	福元洋平	固有一般
ふくもりあきと	福森晃斗	固有一般
ふくもりけんた	福森健太	固有一般
ふくもりなおや	福森直也	固有一般
ふけのりき	吹ヶ徳喜	固有一般
ふけゆうき	福家勇輝	固有一般
ふこういんまこと	普光院誠	固有一般
ふじなおや	藤直也	固有一般
ふじゆうき	冨士祐樹	固有一般
ふじいかずし	藤井一志	固有一般
ふじいこうだい	藤井航大	固有一般
ふじいこうや	藤井皓也	固有一般
ふじいしょうた	藤井翔大	固有一般
ふじいたかし	藤井貴	固有一般
ふじいたかゆき	藤井貴之	固有一般
ふじいだいすけ	藤井大輔	固有一般
ふじいともや	藤井智也	固有一般
ふじいはるや	藤井陽也	固有一般
ふじいひろと	藤井大翔	固有一般
ふじいまさと	藤井柾人	固有一般
ふじいゆうた	藤井悠太	固有一般
ふじいようた	藤井葉大	固有一般
ふじおしょうた	藤尾翔太	固有一般
ふじおかこうすけ	藤岡浩介	固有一般
ふじかわこうじ	藤川康司	固有一般
ふじかわこうたろう	藤川虎太朗	固有一般
ふじかわたかゆき	藤川孝幸	固有一般
ふじかわひさたか	藤川久孝	固有一般
ふじかわゆうじ	藤川祐司	固有一般
ふじがきかいき	藤垣介基	固有一般
ふじがやようすけ	藤ヶ谷陽介	固有一般
ふじさきしょうた	藤﨑将汰	固有一般
ふじさきともき	藤嵜智貴	固有一般
ふじさきよしたか	藤崎義孝	固有一般
ふじさきるい	藤崎琉依	固有一般
ふじさわのりたか	藤澤典隆	固有一般
ふじさわゆうたろう	藤澤優太朗	固有一般
ふしじまえいすけ	藤嶋栄介	固有一般
ふしじまひかる	藤嶋洸	固有一般
ふじたいっとう	藤田一途	固有一般
ふじたいぶき	藤田息吹	固有一般
ふじたかずき	藤田和輝	固有一般
ふじたけん	藤田健	固有一般
ふじたこうへい	藤田浩平	固有一般
ふじたごう	藤田剛	固有一般
ふじたしゅんすけ	藤田峻佑	固有一般
ふじたしんいち	藤田慎一	固有一般
ふじたじょうるちま	藤田譲瑠チマ	固有一般
ふじたせいや	藤田征也	固有一般
ふじたたいせい	藤田泰成	固有一般
ふじたとしや	藤田俊哉	固有一般
ふじたなおゆき	藤田直之	固有一般
ふじたなるみ	藤田成充	固有一般
ふじたまさと	藤田優人	固有一般
ふじたみき	藤田樹	固有一般
ふじたやすと	冨士田康人	固有一般
ふじたゆうと	藤田雄士	固有一般
ふじたよしあき	藤田義明	固有一般
ふじたよしひと	藤田祥史	固有一般
ふじたよしまさ	藤田芳正	固有一般
ふじたけつよし	藤武剛	固有一般
ふじたにそう	藤谷壮	固有一般
ふじたにたくみ	藤谷匠	固有一般
ふじながたいが	藤永大雅	固有一般
ふじぬまたくむ	藤沼拓夢	固有一般
ふじのかいと	藤野快斗	固有一般
ふじのかずき	藤野和樹	固有一般
ふじのこすも	藤野心魂	固有一般
ふじのせいや	藤野聖也	固有一般
ふじはしなおゆき	藤橋尚之	固有一般
ふじはらつとむ	藤原務	固有一般
ふじはらなおあつ	藤原尚篤	固有一般
ふじはらゆうた	藤原悠汰	固有一般
ふじはらよしと	藤原慶人	固有一般
ふじはるひろき	藤春廣輝	固有一般
ふじまきしょうご	藤牧祥吾	固有一般
ふじまつこうや	藤松航矢	固有一般
ふじむらけいた	藤村慶太	固有一般
ふじむらりょうへい	藤村涼平	固有一般
ふじむられん	藤村怜	固有一般
ふじもとかずき	藤本一輝	固有一般
ふじもとかんや	藤本寛也	固有一般
ふじもとこうた	藤本康太	固有一般
ふじもとしゅうじ	藤本修司	固有一般
ふじもとじゅんご	藤本淳吾	固有一般
ふじもとそうま	藤本颯真	固有一般
ふじもとだい	藤本大	固有一般
ふじもとちから	藤本主税	固有一般
ふじもとのりあき	藤本憲明	固有一般
ふじもとゆうや	藤本裕也	固有一般
ふじもとよしき	藤本佳希	固有一般
ふじもとれおん	藤本零音	固有一般
ふじもりりょうじ	藤森亮志	固有一般
ふじやまともふみ	藤山智史	固有一般
ふじやまりゅうじ	藤山竜仁	固有一般
ふじよしかいじろう	藤吉皆二朗	固有一般
ふじよししんじ	藤吉信次	固有一般
ふじわらいっと	藤原一途	固有一般
ふじわらけんすけ	藤原健介	固有一般
ふじわらこうたろう	藤原広太朗	固有一般
ふじわらしりゅう	藤原志龍	固有一般
ふじわらそうや	藤原奏哉	固有一般
ふじわらたくや	藤原拓也	固有一般
ふじわらとわ	藤原十和	固有一般
ふじわらまさと	藤原雅斗	固有一般
ふじわらゆうし	藤原優志	固有一般
ふじわらゆうだい	藤原優大	固有一般
ふせやしょう	布施谷翔	固有一般
ふたかわたかひろ	二川孝広	固有一般
ふたみひろし	二見宏志	固有一般
ふつきしゅんのすけ	夫津木駿之介	固有一般
ふとりよういち	太洋一	固有一般
ふなかわこうしろう	船川航司朗	固有一般
ふなかわたくのすけ	船川琢之介	固有一般
ふなきかける	舩木翔	固有一般
ふなきだいすけ	舩木大輔	固有一般
ふなこしひろむ	船越大夢	固有一般
ふなこしゆうぞう	船越優蔵	固有一般
ふなたにけいすけ	船谷圭祐	固有一般
ふなつてつや	舩津徹也	固有一般
ふなつゆうや	船津佑也	固有一般
ふなはしきょうた	舩橋京汰	固有一般
ふなばしゆう	船橋 佑	固有一般
ふなばしゆうま	船橋勇真	固有一般
ふなやまたかゆき	船山貴之	固有一般
ふなやまゆうじ	船山祐二	固有一般
ふるおかゆうと	古岡佑斗	固有一般
ふるかわかいと	古川海光	固有一般
ふるかわがく	古川雅矩	固有一般
ふるかわたくし	古川隆志	固有一般
ふるかわだいご	古川大悟	固有一般
ふるかわつよし	古川毅	固有一般
ふるかわのぶひさ	古川頌久	固有一般
ふるかわまさあき	古川昌明	固有一般
ふるかわまさと	古川雅人	固有一般
ふるかわようすけ	古川陽介	固有一般
ふるがきふま	古垣風舞	固有一般
ふるさわけいた	古澤慶太	固有一般
ふるしまきよと	古島清人	固有一般
ふるしまけいと	古島圭人	固有一般
ふるたたいじ	古田泰士	固有一般
ふるたとうや	古田東也	固有一般
ふるたひろゆき	古田寛幸	固有一般
ふるたによたろう	古谷陽太郎	固有一般
ふるはしきょうご	古橋亨梧	固有一般
ふるはしたつや	古橋達弥	固有一般
ふるべけんた	古部健太	固有一般
ふるべよしのり	古邊芳昇	固有一般
ふるやそま	古屋颯眞	固有一般
ふるやまさき	古谷真基	固有一般
ふるやゆうほ	古屋雄帆	固有一般
ふるやりくと	古谷陸翔	固有一般
ふるやどりく	古宿理久	固有一般
ふるやまけんご	古山兼悟	固有一般
ふるやまれん	古山蓮	固有一般
ぶらうんのあけんしん	ブラウンノア賢信	固有一般
ぶわにかけいた	ブワニカ啓太	固有一般
べくせうんどん	白 星東	固有一般
ほうしとまさひろ	法師人将大	固有一般
ほうじょうしんた	北條真汰	固有一般
ほうじょうだいち	北條大地	固有一般
ほうじょうまさと	北条真智	固有一般
ほうのうたくと	宝納拓斗	固有一般
ほしとしんや	寶示戸進哉	固有一般
ほかゆうへい	外悠平	固有一般
ほさかかずなり	保坂一成	固有一般
ほさかのぶゆき	保坂信之	固有一般
ほざきすなお	保﨑淳	固有一般
ほしきょーわぁん	星キョーワァン	固有一般
ほしこうた	星広太	固有一般
ほしだいすけ	星大輔	固有一般
ほしゆうじ	星雄次	固有一般
ほしとなる	星戸成	固有一般
ほしのきょう	星野杏	固有一般
ほしのけいすけ	星野圭佑	固有一般
ほしのさとる	星野悟	固有一般
ほしのしんご	星野真悟	固有一般
ほしのしんご	星野晋吾	固有一般
ほしのゆうすけ	星野有亮	固有一般
ほしはらけんた	星原健太	固有一般
ほそかわかえで	細川楓	固有一般
ほそかわこうぞう	細川浩三	固有一般
ほそかわじゅんや	細川淳矢	固有一般
ほそがいはじめ	細貝萌	固有一般
ほそだあゆむ	細田歩夢	固有一般
ほそだかいと	細田海斗	固有一般
ほそだゆうき	細田裕葵	固有一般
ほそやけいご	細谷圭吾	固有一般
ほそやこうへい	細谷航平	固有一般
ほそやまお	細谷真大	固有一般
ほそやゆいと	細谷唯斗	固有一般
ほったしゅうへい	堀田秀平	固有一般
ほっただいき	堀田大暉	固有一般
ほずみこうた	穂積滉太	固有一般
ほずみりょう	穂積諒	固有一般
ほりいぶき	堀伊吹	固有一般
ほりかいと	堀海斗	固有一般
ほりけんた	堀研太	固有一般
ほりけんと	堀健人	固有一般
ほりこうき	堀航輝	固有一般
ほりしゅうと	堀脩大	固有一般
ほりたかふみ	堀孝史	固有一般
ほりともき	堀友希	固有一般
ほりなおと	堀直人	固有一般
ほりいがくや	堀井岳也	固有一般
ほりいけたくみ	堀池巧	固有一般
ほりいけひろみつ	堀池洋充	固有一般
ほりうちはやと	堀内颯人	固有一般
ほりうちようた	堀内陽太	固有一般
ほりえたかひろ	堀江貴大	固有一般
ほりえひびき	堀江響希	固有一般
ほりかねしゅんめい	堀金峻明	固有一般
ほりかわとしひろ	堀河俊大	固有一般
ほりぐちこうへい	堀口皓平	固有一般
ほりぐちゆうと	堀口優人	固有一般
ほりこめはると	堀米遥斗	固有一般
ほりごめゆうき	堀米勇輝	固有一般
ほりごめゆうと	堀米悠斗	固有一般
ほりのうちさとし	堀之内聖	固有一般
ほんみょうぼ	洪明甫	固有一般
ほんじょうりゅうた	本庄竜大	固有一般
ほんだかずま	本田一真	固有一般
ほんだけいすけ	本田圭佑	固有一般
ほんだこうき	本田功輝	固有一般
ほんだこうせい	本田硬靖	固有一般
ほんだこうたろう	本多康太郎	固有一般
ほんだしんご	本田真吾	固有一般
ほんだせいじ	本田征治	固有一般
ほんだたくと	本多琢人	固有一般
ほんだたくや	本田拓也	固有一般
ほんだつよし	本多剛	固有一般
ほんだふうち	本田風智	固有一般
ほんだまさや	本田将也	固有一般
ほんだやすと	本田泰人	固有一般
ほんだゆうき	本多勇喜	固有一般
ほんだよしき	本多慶貴	固有一般
ほんなみけんじ	本並健治	固有一般
ほんまいさお	本間勲	固有一般
ほんまこうじ	本間幸司	固有一般
ほんましおん	本間至恩	固有一般
ほんまじゃすてぃん	本間ジャスティン	固有一般
ほんまはると	本間温士	固有一般
ほんまゆうすけ	本間佑允	固有一般
ほんまようへい	本間洋平	固有一般
ほんまちなおき	本街直樹	固有一般
ほんみょうとしき	本明利樹	固有一般
ほんむらたけあき	本村武揚	固有一般
まいえひでたか	真家英嵩	固有一般
まいくませいや	毎熊晟矢	固有一般
まいけんろんじぇーむず	舞行龍 ジェームズ	固有一般
まえたかゆき	前貴之	固有一般
まえひろゆき	前寛之	固有一般
まえかわかずや	前川和也	固有一般
まえかわしゅうと	前川修音	固有一般
まえかわたいが	前川大河	固有一般
まえかわだいや	前川黛也	固有一般
まえかわともゆき	前川智敬	固有一般
まえかわれん	前川廉	固有一般
ますがわまさゆき	前川正行	固有一般
まえざとゆうき	前里裕希	固有一般
まえざわこうき	前澤甲気	固有一般
まえしろけんや	真栄城兼哉	固有一般
まえじまようた	前嶋洋太	固有一般
まえぞのまさきよ	前園真聖	固有一般
まえだいちか	前田一翔	固有一般
まえだおさむ	前田治	固有一般
まえだかずや	前田和哉	固有一般
まえだかずや	前田和也	固有一般
まえだこういち	前田晃一	固有一般
まえだこうじ	前田浩二	固有一般
まえだしゅう	前田柊	固有一般
まえだしゅんすけ	前田俊介	固有一般
まえだしょうま	前田翔茉	固有一般
まえだたいら	前田泰良	固有一般
まえだたかし	前田隆	固有一般
まえだだいぜん	前田大然	固有一般
まえだなおき	前田直輝	固有一般
まえだなおき	前田尚輝	固有一般
まえだのぶひろ	前田信弘	固有一般
まえだひろき	前田紘基	固有一般
まえだひろき	前田央樹	固有一般
まえだまさふみ	前田雅文	固有一般
まえだゆうすけ	前田悠佑	固有一般
まえだゆうと	前田悠斗	固有一般
まえだよしき	前田義貴	固有一般
まえだりゅうだい	前田龍大	固有一般
まえだりょういち	前田遼一	固有一般
まえだりょうすけ	前田凌佑	固有一般
まえだりょうすけ	前田椋介	固有一般
まえのたかのり	前野貴徳	固有一般
まえむらしょう	前村翔	固有一般
まえやまきょうへい	前山恭平	固有一般
まがりやましゅうと	曲山蹴斗	固有一般
まきこうへい	真木晃平	固有一般
まきせいいちろう	巻誠一郎	固有一般
まきゆうき	巻佑樹	固有一般
まきうちけいた	牧内慶太	固有一般
まきぐちかずま	牧口一真	固有一般
まきしまはあと	牧嶋波亜斗	固有一般
まきたせいいち	巻田清一	固有一般
まきたてっぺい	蒔田哲平	固有一般
まきたりくと	蒔田陸斗	固有一般
まきのかんた	牧野寛太	固有一般
まきのけいすけ	牧野景輔	固有一般
まきのさとる	牧野悟	固有一般
まきのしんじ	牧野真二	固有一般
まきのともあき	槙野智章	固有一般
まきのともや	牧野友哉	固有一般
まきのなおき	牧野直樹	固有一般
まきやまこうせい	牧山晃政	固有一般
まごひでのり	真子秀徳	固有一般
ましまゆうや	間嶋佑弥	固有一般
ますびもてし	真下佐登史	固有一般
ますいけん	倍井謙	固有一般
ますいてっぺい	増井哲平	固有一般
ますおかえいき	升岡栄喜	固有一般
ますかけゆうご	升掛友護	固有一般
ますかわたかひろ	増川隆洋	固有一般
ますこよしひろ	益子義浩	固有一般
ますざきだいご	増崎大虎	固有一般
ますしまたつや	増嶋竜也	固有一般
ますたにこうすけ	増谷幸祐	固有一般
ますたにたから	桝谷岳良	固有一般
ますだおういち	益田欧一	固有一般
ますだけんしょう	増田健昇	固有一般
ますだこうさく	増田功作	固有一般
ますだしげと	増田繁人	固有一般
ますだしゅんじ	増田隼司	固有一般
ますだたくや	増田卓也	固有一般
ますだただとし	増田忠俊	固有一般
ますだちかし	増田誓志	固有一般
ますだはると	増田開登	固有一般
ますだゆうたろう	桝田雄太郎	固有一般
ますだりょうが	桝田凌我	固有一般
ますむらかずき	増村風月	固有一般
ますもりしょうご	増森正悟	固有一般
ますやまあさひ	増山朝陽	固有一般
ますやまつかさ	益山司	固有一般
ませたくみ	真瀬拓海	固有一般
まちだこうき	町田浩樹	固有一般
まちだただみち	町田忠道	固有一般
まちだたもん	町田多聞	固有一般
まちだぶらいと	町田ブライト	固有一般
まちだやまと	町田也真人	固有一般
まちだらんじろう	町田蘭次郎	固有一般
まちのしゅうと	町野修斗	固有一般
まついけんや	松井謙弥	固有一般
まついこうすけ	松井康輔	固有一般
まついだいすけ	松井大輔	固有一般
まついはるき	松井治輝	固有一般
まついりつき	松井陸希	固有一般
まついれんじ	松井蓮之	固有一般
まつうらあつし	松浦敦史	固有一般
まつうらあつし	松浦淳	固有一般
まつうらいさむ	松浦勇武	固有一般
まつうらこうじ	松浦宏治	固有一般
まつうらこうよう	松浦航洋	固有一般
まつうらしょうたろう	松浦祥太郎	固有一般
まつうらたくや	松浦拓弥	固有一般
まつうらなおと	松浦尚人	固有一般
まつうらひであき	松裏英明	固有一般
まつうらひろむ	松浦大武	固有一般
まつおあつし	松尾篤	固有一般
まつおきら	松尾光羅	固有一般
まつおけんた	松尾健太	固有一般
まつおしょうご	松尾昇悟	固有一般
まつおなおと	松尾直人	固有一般
まつおゆういち	松尾侑一	固有一般
まつおゆうすけ	松尾勇佑	固有一般
まつおゆうすけ	松尾佑介	固有一般
まつおかこうや	松岡昂哉	固有一般
まつおかしょうた	松岡翔太	固有一般
まつおかじょなたん	松岡ジョナタン	固有一般
まつおかだいき	松岡大起	固有一般
まつおかだいち	松岡大智	固有一般
まつおかはやと	松岡颯人	固有一般
まつおかやすのぶ	松岡康暢	固有一般
まつおかよしひこ	松岡良彦	固有一般
まつおかるむ	松岡瑠夢	固有一般
まつおかりょうすけ	松岡亮輔	固有一般
まつかわともあき	松川友明	固有一般
まつきくりゅう	松木玖生	固有一般
まつきしゅんのすけ	松木駿之介	固有一般
まつきせいや	松木政也	固有一般
まつくぼたくと	松久保拓斗	固有一般
まつくまひなた	松隈日向太	固有一般
まつざかだにぇるるいす	松坂暖	固有一般
まつざきかい	松崎快	固有一般
まつざわあきら	松澤彰	固有一般
まつざわかいと	松澤海斗	固有一般
まつざわこうき	松澤香輝	固有一般
まつざわはやと	松澤隼人	固有一般
まつしたかずま	松下和磨	固有一般
まつしたこうへい	松下幸平	固有一般
まつしたじゅんと	松下純土	固有一般
まつしただいすけ	松下太輔	固有一般
まつしたとしひろ	松下年宏	固有一般
まつしたなおき	松下直樹	固有一般
まつしたゆうき	松下裕樹	固有一般
まつしたよしき	松下佳貴	固有一般
まつしたやすし	松下泰士	固有一般
まつしまこうせい	松嶋好誠	固有一般
まつしまひとし	松島仁	固有一般
まつだえいたろう	松田詠太郎	固有一般
まつだかずや	松田和也	固有一般
まつだけいた	松田佳大	固有一般
まつだけんた	松田賢太	固有一般
まつだこうすけ	松田康佑	固有一般
まつだつとむ	松田勉	固有一般
まつだてんま	松田天馬	固有一般
まつだとのま	松田飛乃舞	固有一般
まつだなおき	松田直樹	固有一般
まつだはやて	松田隼風	固有一般
まつだはるふみ	松田春文	固有一般
まつだひでき	松田英樹	固有一般
まつだひろし	松田浩	固有一般
まつだまさとし	松田正俊	固有一般
まつだゆうすけ	松田悠佑	固有一般
まつだよしのり	松田考功	固有一般
まつだりき	松田力	固有一般
まつだりく	松田陸	固有一般
まつながかいと	松永海斗	固有一般
まつながかずよし	松永一慶	固有一般
まつながしげたつ	松永成立	固有一般
まつながしょうへい	松永祥兵	固有一般
まつながねゆうと	松長根悠仁	固有一般
まつなみまさのぶ	松波正信	固有一般
まつはししょうた	松橋章太	固有一般
まつはしまさる	松橋優	固有一般
まつはしゆあん	松橋優安	固有一般
まつはしりきぞう	松橋力蔵	固有一般
まつばらかいせい	松原快晟	固有一般
まつばらけん	松原健	固有一般
まつばらこう	松原后	固有一般
まつばらこうき	松原亘紀	固有一般
まつばらしゅうへい	松原修平	固有一般
まつばらしゅうも	松原秀模	固有一般
まつばらしょうた	松原翔太	固有一般
まつばらそうた	松原颯汰	固有一般
まつばらたいが	松原大芽	固有一般
まつばらただあき	松原忠明	固有一般
まつばらだいき	松原大貴	固有一般
まつばらひろき	松原浩樹	固有一般
まつばらゆうき	松原優吉	固有一般
まつばらよしか	松原良香	固有一般
まつばられん	松原蓮	固有一般
まつふじまさのぶ	松藤正伸	固有一般
まつむらこうき	松村航希	固有一般
まつむらこうすけ	松村晃助	固有一般
まつむらしゅんすけ	松村駿佑	固有一般
まつむらせれ	松村晟怜	固有一般
まつむらはると	松村遥人	固有一般
まつむらゆうた	松村優太	固有一般
まつむらゆり	松村祐吏	固有一般
まつむらりょう	松村亮	固有一般
まつもとあいき	松本愛己	固有一般
まつもとあゆむ	松本歩夢	固有一般
まつもとかんた	松本幹太	固有一般
まつもとけいすけ	松本圭介	固有一般
まつもとけん	松本憲	固有一般
まつもとけんちざんが	松本ケンチザンガ	固有一般
まつもとけんた	松本健太	固有一般
まつもとけんたろう	松本健太郎	固有一般
まつもとこうせい	松本皐誠	固有一般
まつもとこうへい	松本孝平	固有一般
まつもとしょう	松本翔	固有一般
まつもとたいし	松本泰志	固有一般
まつもとたいち	松本太一	固有一般
まつもとたかとし	松本昂聡	固有一般
まつもとたくや	松本拓也	固有一般
まつもとだいき	松本大輝	固有一般
まつもとだいじゅ	松本大樹	固有一般
まつもとだいすけ	松本大輔	固有一般
まつもとなおや	松本直也	固有一般
まつもとなぎ	松本凪生	固有一般
まつもとはると	松本遥翔	固有一般
まつもとひろや	松本大弥	固有一般
まつもとひろゆき	松本浩幸	固有一般
まつもとまさや	松本昌也	固有一般
まつもとやすし	松本安司	固有一般
まつもとゆうき	松本祐樹	固有一般
まつもとゆうま	松本雄真	固有一般
まつもとようすけ	松本陽介	固有一般
まつもとりく	松本陸	固有一般
まつもとれお	松本怜大	固有一般
まつもとれい	松本怜	固有一般
まつもとれん	松本蓮	固有一般
まつやまけんた	松山健太	固有一般
まつやまだいち	松山大地	固有一般
まつやまひろあき	松山博明	固有一般
まつやまよしゆき	松山吉之	固有一般
まつよなおき	松代直樹	固有一般
またなかしゅうば	眞中脩羽	固有一般
またなかひろと	眞中裕都	固有一般
またなかみきお	眞中幹夫	固有一般
またなかやすお	眞中靖夫	固有一般
まなべはやと	真鍋隼虎	固有一般
まなべひかる	眞鍋旭輝	固有一般
まなべひかる	真鍋光	固有一般
まのりょうじ	真野亮二	固有一般
まるおかさとる	丸岡悟	固有一般
まるおかみつる	丸岡満	固有一般
まるたにたくや	丸谷拓也	固有一般
まるはしゆうすけ	丸橋祐介	固有一般
まるもとゆうへい	丸本侑平	固有一般
まるやまきら	丸山貴羅	固有一般
まるやまこうき	丸山皓己	固有一般
まるやましゅうと	丸山嵩大	固有一般
まるやまそうた	丸山壮大	固有一般
まるやまゆういち	丸山祐市	固有一般
まるやまゆうたろう	丸山優太朗	固有一般
まるやまよしあき	丸山良明	固有一般
まわたりかずあき	馬渡和彰	固有一般
まわたりじゅんき	馬渡隼暉	固有一般
まわたりひろき	馬渡洋樹	固有一般
まんしょみつる	満生充	固有一般
みうらあきと	三浦旭人	固有一般
みうらあつひろ	三浦淳宏	固有一般
みうらおさむ	三浦修	固有一般
みうらかずよし	三浦知良	固有一般
みうらげんた	三浦弦太	固有一般
みうらこうき	三浦康希	固有一般
みうらごうた	三浦豪太	固有一般
みうらしゅんた	三浦隼太	固有一般
みうらそうた	三浦颯太	固有一般
みうらとしくに	三浦敏邦	固有一般
みうらふみたけ	三浦文丈	固有一般
みうらもとあき	三浦基瑛	固有一般
みうらやすとし	三浦泰年	固有一般
みうらゆうすけ	三浦雄介	固有一般
みうらゆうと	三浦悠斗	固有一般
みうらゆうや	三浦雄也	固有一般
みうらりゅうき	三浦龍輝	固有一般
みおあつし	美尾敦	固有一般
みかどゆうた	三門雄大	固有一般
みかみあきのり	三上明紀	固有一般
みかみかずよし	三上和良	固有一般
みかみたくや	三上卓哉	固有一般
みかみようすけ	三上陽輔	固有一般
みかもとうあ	美甘仁愛	固有一般
みきかい	三鬼海	固有一般
みきたかし	三木隆司	固有一般
みきともや	見木友哉	固有一般
みきなおと	三木直土	固有一般
みきりょうた	三木良太	固有一般
みきぶいとる	三木ヴィトル	固有一般
みぎたかえで	右田楓	固有一般
みくにけねでぃえぶす	三國ケネディエブス	固有一般
みくにすてぃびあえぶす	三國スティビアエブス	固有一般
みくりやけい	御厨景	固有一般
みくりやたかふみ	御厨貴文	固有一般
みさおけんと	三竿健斗	固有一般
みさおゆうと	三竿雄斗	固有一般
みさきみつひろ	見崎充洋	固有一般
みさだせいた	美佐田誠大	固有一般
みさわけいいち	三澤慶一	固有一般
みさわじゅんいち	三澤純一	固有一般
みさわたくほ	見澤拓歩	固有一般
みさわなおと	三沢直人	固有一般
みしまこうへい	三島康平	固有一般
みしましょうへい	三島頌平	固有一般
みしまゆうた	三島勇太	固有一般
みしろときとら	三城怜虎	固有一般
みずうちたけし	水内猛	固有一般
みずかみしゅり	水上珠吏	固有一般
みずきこうせい	水木康誠	固有一般
みずきまさと	水木将人	固有一般
みずきゆうふみ	水筑優文	固有一般
みずくらけい	水倉慧	固有一般
みずぐちひろ	水口飛呂	固有一般
みずぐちゆうと	水口由翔	固有一般
みずこしじゅん	水越潤	固有一般
みずさきやすし	水崎靖	固有一般
みずさわしゅんた	水沢俊太	固有一般
みずたゆうま	水田雄真	固有一般
みずたにあゆむ	水谷歩夢	固有一般
みずたにたくま	水谷拓磨	固有一般
みずたにまさとし	水谷允俊	固有一般
みずたにゆういち	水谷雄一	固有一般
みずたにゆうや	水谷友哉	固有一般
みずながしょうま	水永翔馬	固有一般
みずぬまこうた	水沼宏太	固有一般
みずぬまたかし	水沼貴史	固有一般
みずのこうき	水野晃樹	固有一般
みずのじゅん	水野淳	固有一般
みずのたいすけ	水野泰輔	固有一般
みずのともひろ	水野智大	固有一般
みずのはやた	水野颯太	固有一般
みずのひかる	水野輝	固有一般
みずはらひろき	水原大樹	固有一般
みずもとかつなり	水本勝成	固有一般
みずもとひろき	水本裕貴	固有一般
みぞうえけいすけ	溝上敬佑	固有一般
みぞぐちしゅうへい	溝口修平	固有一般
みぞぐちはるひ	溝口陽日	固有一般
みぞぶちゆうし	溝渕雄志	固有一般
みたひかる	三田光	固有一般
みたひさお	三田尚央	固有一般
みたひろたか	三田啓貴	固有一般
みたまさゆき	見田雅之	固有一般
みちうえはやと	道上隼人	固有一般
みちきりゅうじ	路木龍次	固有一般
みちぶちりょうへい	道渕諒平	固有一般
みちわきゆたか	道脇豊	固有一般
みついだいき	三井大輝	固有一般
みつおかしんや	光岡眞矢	固有一般
みつざきしん	光崎伸	固有一般
みつぞのしゅうたろう	満園修太郎	固有一般
みつたまこと	満田誠	固有一般
みつだはるき	三ッ田啓希	固有一般
みつながたいせい	光永大晟	固有一般
みつながゆうや	光永祐也	固有一般
みつはししゅうへい	三橋秀平	固有一般
みつはしたくま	三橋拓真	固有一般
みつひらかずし	三平和司	固有一般
みつひろけんり	光廣健利	固有一般
みつふじかいせい	光藤海晴	固有一般
みつふじりょうや	光藤諒也	固有一般
みつまるひろむ	三丸拡	固有一般
みとしゅんすけ	三戸舜介	固有一般
みとりん	美藤倫	固有一般
みとべとうじ	水戸部東次	固有一般
みとまかおる	三笘薫	固有一般
みながわしょうた	皆川翔太	固有一般
みながわゆうすけ	皆川佑介	固有一般
みなくちこうすけ	水口耕輔	固有一般
みなくちゆうと	水口湧斗	固有一般
みなみこうた	南光太	固有一般
みなみしゅうと	南秀仁	固有一般
みなみたくと	南拓都	固有一般
みなみひろき	皆見宏樹	固有一般
みなみまなぶ	己浪学	固有一般
みなみゆうぞう	南祐三	固有一般
みなみゆうた	南雄太	固有一般
みなみりょうた	南稜大	固有一般
みなみのたくみ	南野拓実	固有一般
みなみのはるみ	南野遥海	固有一般
みなもとかつひろ	皆本勝弘	固有一般
みねかずき	三根和起	固有一般
みねはやと	峯勇斗	固有一般
みねぎしけいすけ	嶺岸佳介	固有一般
みねぎしりおん	嶺岸凛音	固有一般
みのだこうだい	蓑田広大	固有一般
みのべなおひこ	美濃部直彦	固有一般
みのわよしのぶ	箕輪義信	固有一般
みはしたくや	三橋拓也	固有一般
みはらこうへい	三原向平	固有一般
みはらしゅうま	三原秀真	固有一般
みはらたくや	三原拓也	固有一般
みはらなおき	三原直樹	固有一般
みはらひろき	三原廣樹	固有一般
みはらひろゆき	三原大幸	固有一般
みはらまさとし	三原雅俊	固有一般
みふねこうせい	三舩煌晴	固有一般
みまかずや	美馬和也	固有一般
みむらまこと	三村真	固有一般
みやだいき	宮大樹	固有一般
みやいちつよし	宮市剛	固有一般
みやいちりょう	宮市亮	固有一般
みやうちひろと	宮内寛斗	固有一般
みやうちゆうき	宮内雄希	固有一般
みやうちりゅうた	宮内龍汰	固有一般
みやおこういち	宮尾孝一	固有一般
みやかわだいすけ	宮川大輔	固有一般
みやがわさとし	宮川悟	固有一般
みやがわだいき	宮川大輝	固有一般
みやぎかずや	宮城和也	固有一般
みやぎこうた	宮城晃太	固有一般
みやぎてん	宮城天	固有一般
みやぎまさふみ	宮城雅史	固有一般
みやくらじゅりあん	宮倉樹里杏	固有一般
みやけかいと	三宅海斗	固有一般
みやけたかのり	三宅貴憲	固有一般
みやけひろき	三宅浩暉	固有一般
みやけりゅうと	三宅龍人	固有一般
みやさかまさき	宮阪政樹	固有一般
みやざきかいと	宮㟢海斗	固有一般
みやざききわら	宮崎幾笑	固有一般
みやざきけいしん	宮崎圭伸	固有一般
みやざきけんじ	宮崎健治	固有一般
みやざきこう	宮崎鴻	固有一般
みやざきこうた	宮崎航汰	固有一般
みやざきこうへい	宮崎光平	固有一般
みやざきじゅんま	宮崎純真	固有一般
みやざきたいすけ	宮崎泰右	固有一般
みやざきだいしろう	宮崎大志郎	固有一般
みやざきともひこ	宮崎智彦	固有一般
みやざきひなた	宮崎陽	固有一般
みやざわかつゆき	宮沢克行	固有一般
みやざわつばさ	宮澤飛翔	固有一般
みやざわひろき	宮澤裕樹	固有一般
みやざわひろし	宮澤浩	固有一般
みやざわまさし	宮沢正史	固有一般
みやざわみっしぇる	宮澤ミッシェル	固有一般
みやしたけいた	宮下渓太	固有一般
みやしたしゅうほ	宮下周歩	固有一般
みやしたはやと	宮下隼	固有一般
みやしたまさひろ	宮下真洋	固有一般
みやしろたいせい	宮代大聖	固有一般
みやじようすけ	宮路洋輔	固有一般
みやじまだいき	宮嶋大輝	固有一般
みやじまゆう	宮島裕	固有一般
みやたいずみ	宮田和純	固有一般
みやたけんたろう	宮田健太郎	固有一般
みやたなおき	宮田直樹	固有一般
みやたはる	宮田遥	固有一般
みやたりょうすけ	宮田涼介	固有一般
みやちげんき	宮地元貴	固有一般
みやはらあいき	宮原愛輝	固有一般
みやはらかずや	宮原和也	固有一般
みやはらゆうじ	宮原裕司	固有一般
みやはらゆうた	宮原勇太	固有一般
みやべたいき	宮部大己	固有一般
みやむらまさし	宮村正志	固有一般
みやむらりく	宮村離玖	固有一般
みやもとあらた	宮本新	固有一般
みやもとあれん	宮本歩蓮	固有一般
みやもといちたか	宮本一貴	固有一般
みやもとえいじ	宮本英治	固有一般
みやもとこうた	宮本航汰	固有一般
みやもとたくみ	宮本拓海	固有一般
みやもとたくや	宮本卓也	固有一般
みやもとたくや	宮本拓弥	固有一般
みやもとつねやす	宮本恒靖	固有一般
みやもとてつひろ	宮本哲宏	固有一般
みやもととおる	宮本亨	固有一般
みやもととしあき	宮本駿晃	固有一般
みやもとみきはる	宮本樹明	固有一般
みやもとゆう	宮本優	固有一般
みやもとゆうた	宮本優太	固有一般
みやもとゆきあ	宮本幸亜	固有一般
みやもとらいや	宮本頼哉	固有一般
みやもとりゅう	宮本龍	固有一般
みやもとるい	宮本流維	固有一般
みやよしたくみ	宮吉拓実	固有一般
みやわきけんた	宮脇健太	固有一般
みやわきしげお	宮脇茂夫	固有一般
みゆきひでとし	三幸秀稔	固有一般
みょがんとや	名願斗哉	固有一般
みょうじんともかず	明神智和	固有一般
みょうどうかずや	明堂和也	固有一般
みよしきよたか	三吉聖王	固有一般
みよしこうじ	三好康児	固有一般
みよししゅうと	三好崇斗	固有一般
みよしたくじ	三好拓児	固有一般
みよしひろちか	三好洋央	固有一般
むかいあきと	向井章人	固有一般
むかいしんいち	向慎一	固有一般
むかいはやて	向井颯	固有一般
むぎくらなつき	麦倉捺木	固有一般
むぎたかずゆき	麦田和志	固有一般
むくけんた	椋健太	固有一般
むくはらけんた	椋原健太	固有一般
むぐるまたくや	六車拓也	固有一般
むこがわたかと	向川空斗	固有一般
むこじまたつる	向島建	固有一般
むこじまみつる	向島満	固有一般
むさかみつなり	六平光成	固有一般
むしゃひろむ	武者大夢	固有一般
むたゆうすけ	牟田雄祐	固有一般
むとうしんいち	武藤真一	固有一般
むとうゆうき	武藤友樹	固有一般
むとうゆうき	武藤雄樹	固有一般
むとうよしのり	武藤嘉紀	固有一般
むなかたひろふみ	棟方博文	固有一般
むねちかけい	宗近慧	固有一般
むらいしんじ	村井慎二	固有一般
むらいせいた	村井清太	固有一般
むらいせいた	村井清大	固有一般
むらいたいき	村井泰希	固有一般
むらおたつや	村尾龍矢	固有一般
むらおかたくや	村岡拓哉	固有一般
むらかみかずき	村上一樹	固有一般
むらかみかずひろ	村上和弘	固有一般
むらかみきっぺい	村上桔平	固有一般
むらかみけいし	村上景司	固有一般
むらかみせいや	村上聖弥	固有一般
むらかみたくみ	村上巧	固有一般
むらかみたつき	村上竜規	固有一般
むらかみまさあき	村上昌謙	固有一般
むらかみゆうすけ	村上佑介	固有一般
むらかみゆうひ	村上悠緋	固有一般
むらかみゆきと	村上千歩	固有一般
むらきしんじ	村木伸二	固有一般
むらきひかる	村木輝	固有一般
むらこしかいが	村越凱光	固有一般
むらしたしょうご	村下将梧	固有一般
むらせかずたか	村瀬和隆	固有一般
むらせしん	村瀬心	固有一般
むらせゆうすけ	村瀬悠介	固有一般
むらせゆうた	村瀬勇太	固有一般
むらたかずひろ	村田一弘	固有一般
むらたかずや	村田和哉	固有一般
むらたこういち	村田航一	固有一般
むらたしょう	村田翔	固有一般
むらたたつや	村田達哉	固有一般
むらたとま	村田透馬	固有一般
むらたのりお	村田教生	固有一般
むらたまさき	村田聖樹	固有一般
むらなかそういちろう	村中総一郎	固有一般
むらまつこうた	村松航太	固有一般
むらまつじゅん	村松潤	固有一般
むらまつたいすけ	村松大輔	固有一般
むらまつともき	村松知輝	固有一般
むらまつゆきのり	村松幸典	固有一般
むらもとそうた	村本相太	固有一般
むらやまかんじ	村山勘治	固有一般
むらやまたくま	村山拓真	固有一般
むらやまともひこ	村山智彦	固有一般
むらやまゆうすけ	村山祐介	固有一般
むろたくや	室拓哉	固有一般
むろいいちえい	室井市衛	固有一般
むろいけいすけ	室井彗佑	固有一般
むろつはやと	室津颯斗	固有一般
むろやせい	室屋成	固有一般
もんいんじゅ	文仁柱	固有一般
もんじょちゅん	文濟天	固有一般
もんじゅうぐん	文周元	固有一般
めいそんのあ	メイソン埜吾	固有一般
めしのそうま	食野壮磨	固有一般
めしのりょうたろう	食野亮太郎	固有一般
めたけんいちろう	米田兼一郎	固有一般
めつぎけいご	目次啓悟	固有一般
めつぎこうせい	目次康晟	固有一般
もうりしゅんや	毛利駿也	固有一般
もぎかつゆき	茂木克行	固有一般
もぎしゅう	茂木秀	固有一般
もぎひろと	茂木弘人	固有一般
もちいきょうた	持井響太	固有一般
もちづきこうへい	望月耕平	固有一般
もちづきさとる	望月聡	固有一般
もちづきしげよし	望月重良	固有一般
もちづきたつや	望月達也	固有一般
もちづきちかゆき	望月慎之	固有一般
もちづきまさと	望月理人	固有一般
もちづきゆうしん	望月勇伸	固有一般
もちづきりゅうじ	望月竜次	固有一般
もちづきれお	望月嶺臣	固有一般
もちどめしんさく	持留新作	固有一般
もてきしゅうや	茂木柊哉	固有一般
もてぎしゅんすけ	茂木駿佑	固有一般
もてぎりきや	茂木力也	固有一般
もといしなつ	本石捺	固有一般
もときれおん	元木玲音	固有一般
もとだあらた	許田新太	固有一般
もとだりゅうや	元田龍矢	固有一般
もとづかとしや	本塚聖也	固有一般
もとはしたくみ	本橋卓巳	固有一般
もとみやしゅうと	本宮周東	固有一般
もとやましょうげん	本山鐘現	固有一般
もとやまはるか	本山遥	固有一般
もとやままさし	本山雅志	固有一般
もとよしたけし	本吉剛	固有一般
もにわてるゆき	茂庭照幸	固有一般
もはまどふぁるざんさな	モハマドファルザン佐名	固有一般
もみたにまさひろ	籾谷真弘	固有一般
もよまるこむきょうし	モヨマルコム強志	固有一般
もりあつひこ	森敦彦	固有一般
もりえいじろう	森英次郎	固有一般
もりかいと	森海渡	固有一般
もりかずひろ	森一紘	固有一般
もりけいすけ	森惠佑	固有一般
もりけんいち	森賢一	固有一般
もりこうた	森晃太	固有一般
もりこうたつ	森厚達	固有一般
もりこうだい	森昂大	固有一般
もりしゅんすけ	森俊介	固有一般
もりじゅんいち	森純一	固有一般
もりたいじろう	森泰次郎	固有一般
もりとしき	森俊貴	固有一般
もりなおき	森直樹	固有一般
もりはるや	森春也	固有一般
もりひであき	森秀昭	固有一般
もりまさあき	森正明	固有一般
もりゆうすけ	森勇介	固有一般
もりゆうと	森勇人	固有一般
もりゆり	森侑里	固有一般
もりゆうま	森夢真	固有一般
もりよういち	森陽一	固有一般
もりようすけ	森洋介	固有一般
もりようへい	森陽平	固有一般
もりりいた	森璃太	固有一般
もりおかしげる	森岡茂	固有一般
もりおかりく	森岡陸	固有一般
もりおかりゅうぞう	森岡隆三	固有一般
もりおかりょうた	森岡亮太	固有一般
もりかわたいしん	森川泰臣	固有一般
もりかわたくみ	森川拓巳	固有一般
もりかわとおる	森川徹	固有一般
もりかわゆうき	森川裕基	固有一般
もりかわりゅうせい	森川龍誠	固有一般
もりさきかずゆき	森﨑和幸	固有一般
もりさきこうじ	森﨑浩司	固有一般
もりさきよしゆき	森崎嘉之	固有一般
もりしげたつや	森重達也	固有一般
もりしげまさと	森重真人	固有一般
もり	森重陽介	固有一般
もりしたこたろう	森下虎太郎	固有一般
もりしたしゅん	森下俊	固有一般
もりしたしんいち	森下申一	固有一般
もりしたはるか	森下悠	固有一般
もりしたひとし	森下仁志	固有一般
もりしたりょうや	森下龍矢	固有一般
もりしたれいや	森下怜哉	固有一般
もりしまつかさ	森島司	固有一般
もりしまひろあき	森島寛晃	固有一般
もりしまやすひと	森島康仁	固有一般
もりぞのたかひと	森園貴仁	固有一般
もりたこういちろう	森田耕一郎	固有一般
もりたこうき	森田晃樹	固有一般
もりたこうへい	盛田剛平	固有一般
もりたしょう	森田翔	固有一般
もりたしんご	森田慎吾	固有一般
もりたしんご	森田真吾	固有一般
もりたしんじ	森田真司	固有一般
もりたそう	守田創	固有一般
もりたたつや	守田達弥	固有一般
もりたつばさ	森田翼	固有一般
もりたなる	森田成	固有一般
もりたはやた	森田颯太	固有一般
もりたひでまさ	守田英正	固有一般
もりたひろし	森田浩史	固有一般
もりたゆうき	森田侑樹	固有一般
もりたゆうと	森田友翔	固有一般
もりたりん	森田凜	固有一般
もりたれん	森田蓮	固有一般
もりむらこうた	森村昂太	固有一般
もりもといぶき	森本聖希	固有一般
もりもとしんいち	森本慎一	固有一般
もりもとそらと	森本空斗	固有一般
もりもとたかゆき	森本貴幸	固有一般
もりもとだいき	森本大貴	固有一般
もりもとつかさ	森本良	固有一般
もりもとひまん	森本ヒマン	固有一般
もりやかずと	森谷一斗	固有一般
もりやけいすけ	森谷佳祐	固有一般
もりやけんたろう	森谷賢太郎	固有一般
もりやはやと	守屋颯人	固有一般
もりやすしょうへい	森保翔平	固有一般
もりやすはじめ	森保一	固有一般
もりやすひろし	森保洋	固有一般
もりやすひろふみ	森安洋文	固有一般
もりやすりく	森保陸	固有一般
もりやまきみや	森山公弥	固有一般
もりやまけんじ	守山健二	固有一般
もりやましんご	森山真伍	固有一般
もりやまともひろ	森山友裕	固有一般
もりやまやすゆき	森山泰行	固有一般
もりやまよしろう	森山佳郎	固有一般
もりよしゆうたろう	森吉優太郎	固有一般
もりわきりょうた	森脇良太	固有一般
もれいられおなるど	盛礼良 レオナルド	固有一般
もろおかしゅう	師岡柊生	固有一般
もろおかひろと	諸岡裕人	固有一般
やがらけんいち	八柄堅一	固有一般
やぎかいせい	矢木海成	固有一般
やぎたいせい	八木大政	固有一般
やぎひろと	八木大翔	固有一般
やぎしただいき	柳下大樹	固有一般
やぎぬましゅん	八木沼瞬	固有一般
やくしじだいき	薬師寺大繋	固有一般
やぐちしゅんたろう	矢口駿太郎	固有一般
やざわたつや	谷澤達也	固有一般
やしきゆうせい	屋敷優成	固有一般
やしろさとし	八代敏	固有一般
やじまきいち	矢島輝一	固有一般
やじましんや	矢島慎也	固有一般
やじまたくろう	矢島卓郎	固有一般
やすいかいと	安居海渡	固有一般
やすいたくや	安井拓也	固有一般
やすかわゆう	安川有	固有一般
やすたけとおる	安武亨	固有一般
やすだけんしん	保田堅心	固有一般
やすだこうすけ	安田亘佑	固有一般
やすだこうだい	安田晃大	固有一般
やすだこうじろう	安田虎士朗	固有一般
やすだなる	保田成琉	固有一般
やすだみちひろ	安田理大	固有一般
やすだゆうき	安田祐生	固有一般
やすながそうたろう	安永聡太郎	固有一般
やすながみど	安永海童	固有一般
やすながれお	安永玲央	固有一般
やすはらなりやす	安原成泰	固有一般
やすみつしょうさく	安光将作	固有一般
やそゆうじ	八十祐治	固有一般
やたがいそうき	矢田貝壮貴	固有一般
やたあさひ	矢田旭	固有一般
やだゆうすけ	谷田悠介	固有一般
やだりゅうのすけ	矢田龍之介	固有一般
やちだてっぺい	谷内田哲平	固有一般
やつだこうすけ	八田康介	固有一般
やないあつし	柳井敦志	固有一般
やながわまさき	柳川雅樹	固有一般
やなぎおうじろう	柳欧治郎	固有一般
やなぎたかひろ	柳貴博	固有一般
やなぎやすたか	柳育崇	固有一般
やなぎゆうたろう	柳雄太郎	固有一般
やなぎりくと	柳陸斗	固有一般
やなぎさわあつし	柳沢敦	固有一般
やなぎさわこう	柳澤亘	固有一般
やなぎさわこうた	柳澤宏太	固有一般
やなぎさわじゅん	柳澤隼	固有一般
やなぎさわまさゆき	柳沢将之	固有一般
やなぎざきしょうへい	柳崎祥兵	固有一般
やなぎそのりょうた	柳園良太	固有一般
やなぎだけんた	柳田健太	固有一般
やなぎだたくみ	桺田拓海	固有一般
やなぎまちかいよう	柳町魁耀	固有一般
やなぎもとひろしげ	柳本啓成	固有一般
やなしばまさや	柳下将野	固有一般
やなむらはるき	柳村治輝	固有一般
やのきしょう	矢野貴章	固有一般
やのたいち	矢野太一	固有一般
やのだいすけ	矢野大輔	固有一般
やのはやと	矢野隼人	固有一般
やのまいける	矢野マイケル	固有一般
やのゆうすい	矢野佑粋	固有一般
やはたとしひろ	矢畑智裕	固有一般
やぶゆうじ	養父雄仁	固有一般
やぶうちけんと	薮内健人	固有一般
やぶさきしんや	薮崎真哉	固有一般
やぶたみつのり	藪田光教	固有一般
やべじろう	矢部次郎	固有一般
やまうちあきら	山内彰	固有一般
やまうちかける	山内翔	固有一般
やまうちかんてる	山内勘暉	固有一般
やまうちけいた	山内恵太	固有一般
やまうちこうだい	山内康太	固有一般
やまうちしゅうせい	山内舟征	固有一般
やまうちたかお	山内貴雄	固有一般
やまうちたつろう	山内達朗	固有一般
やまうちともひろ	山内智裕	固有一般
やまうちはるき	山内晴貴	固有一般
やまうちひなた	山内日向汰	固有一般
やまうちひろふみ	山内寛史	固有一般
やまうちゆういち	山内祐一	固有一般
やまうちゆうま	山内悠真	固有一般
やまうちりく	山内陸	固有一般
やまおみつのり	山尾光則	固有一般
やまおかくんぺい	山岡薫平	固有一般
やまおかてつや	山岡哲也	固有一般
やまかわてつし	山川哲史	固有一般
やまかわでしょんりょう	山川デション諒	固有一般
やまかわれん	山川廉	固有一般
やまがかずき	山賀和輝	固有一般
やまがたきょうへい	山形恭平	固有一般
やまがたたつのり	山形辰徳	固有一般
やまがわだいち	山側大地	固有一般
やまぎしさとる	山岸智	固有一般
やまぎしのりひろ	山岸範宏	固有一般
やまぎしゆうや	山岸祐也	固有一般
やまくらわたる	山倉渉	固有一般
やまぐちあつし	山口篤史	固有一般
やまぐちかずき	山口和樹	固有一般
やまぐちかずま	山口一真	固有一般
やまぐちけい	山口慶	固有一般
やまぐちさとし	山口智	固有一般
やまぐちしょうだい	山口将大	固有一般
やまぐちしんじ	山口真司	固有一般
やまぐちせいや	山口聖矢	固有一般
やまぐちたかひろ	山口貴弘	固有一般
やまぐちたかゆき	山口貴之	固有一般
やまぐちたくみ	山口卓己	固有一般
やまぐちたけし	山口武士	固有一般
やまぐちたつや	山口竜弥	固有一般
やまぐちだいき	山口大輝	固有一般
やまぐちてつはる	山口哲治	固有一般
やまぐちとしひろ	山口敏弘	固有一般
やまぐちほたる	山口 蛍	固有一般
やまぐちもとひろ	山口素弘	固有一般
やまぐちゆうき	山口優樹	固有一般
やまぐちゆうき	山口勇気	固有一般
やまぐちりゅうき	山口隆希	固有一般
やまぐちるい	山口瑠伊	固有一般
やまこしきょうたろう	山越享太郎	固有一般
やまこしこうへい	山越康平	固有一般
やまさきおが	山﨑桜我	固有一般
やまざききいち	山崎希一	固有一般
やまざきしゅうき	山崎宗樹	固有一般
やまざきしゅうと	山崎柊人	固有一般
やまさきたいち	山﨑大地	固有一般
やまざきまさと	山崎理人	固有一般
やまさきりく	山﨑琉空	固有一般
やまさきりむ	山﨑琉夢	固有一般
やまざきりょうご	山﨑 凌吾	固有一般
やまさきるか	山﨑琉煌	固有一般
やまざきかける	山崎翔流	固有一般
やまざきこうすけ	山﨑浩介	固有一般
やまざきこうせい	山﨑公誠	固有一般
やまざきこうたろう	山崎光太郎	固有一般
やまざきたいしん	山崎太新	固有一般
やまざきたかまさ	山﨑貴雅	固有一般
やまざきてつや	山崎哲也	固有一般
やまざきまこと	山崎真	固有一般
やまざきまさと	山﨑 雅人	固有一般
やまざきまさと	山﨑正登	固有一般
やまざきゆうき	山崎侑輝	固有一般
やまざきりょうすけ	山崎稜介	固有一般
やまざきりょうへい	山崎亮平	固有一般
やまざきりん	山崎倫	固有一般
やまざきわたる	山崎渡	固有一般
やましたくにひろ	山下訓広	固有一般
やましたけいた	山下敬大	固有一般
やましたしょうま	山下将真	固有一般
やましたそうたろう	山下湊太郎	固有一般
やましたたつや	山下達也	固有一般
やましたゆだい	山下雄大	固有一般
やましたゆうと	山下優人	固有一般
やましたよしみ	山下芳輝	固有一般
やましたらいど	山下莉人	固有一般
やましたりょう	山下諒	固有一般
やましたりょうじ	山下諒時	固有一般
やましたりょうや	山下諒也	固有一般
やましたれお	山下令雄	固有一般
やましたれん	山下廉	固有一般
やましろじゅんや	山城純也	固有一般
やまじいっさ	山地一颯	固有一般
やまじよしひと	山路嘉人	固有一般
やませこうじ	山瀬功治	固有一般
やませゆきひろ	山瀬幸宏	固有一般
やまだいつき	山田樹	固有一般
やまだかいと	山田海斗	固有一般
やまだきお	山田葵士	固有一般
やまだきょうや	山田恭也	固有一般
やまだきらと	山田煌人	固有一般
やまだけんじ	山田賢二	固有一般
やまだげんき	山田元気	固有一般
やまだこうしん	山田光真	固有一般
やまだこうじ	山田晃士	固有一般
やまだこうた	山田康太	固有一般
やまだこうへい	山田晃平	固有一般
やまだごうき	山田剛綺	固有一般
やまだしゅうへい	山田周平	固有一般
やまだしゅうへい	山田修平	固有一般
やまだしう	山田士雄	固有一般
やまだしん	山田新	固有一般
やまだたいき	山田泰樹	固有一般
やまだたいき	山田大樹	固有一般
やまだたかひろ	山田隆裕	固有一般
やまだたかふみ	山田貴文	固有一般
やまだたくみ	山田拓巳	固有一般
やまだたくや	山田卓也	固有一般
やまだつばさ	山田翼	固有一般
やまだなお	山田奈央	固有一般
やまだなおき	山田直輝	固有一般
やまだなおゆき	山田尚幸	固有一般
やまだのぶひさ	山田暢久	固有一般
やまだひろき	山田大記	固有一般
やまだひろと	山田太翔	固有一般
やまだひろと	山田寛人	固有一般
やまだふうき	山田楓喜	固有一般
やまだまさみち	山田正道	固有一般
やまだまさゆき	山田将之	固有一般
やまだまなと	山田真夏斗	固有一般
やまだみつお	山田満夫	固有一般
やまだやすひろ	山田泰寛	固有一般
やまだゆうき	山田祐樹	固有一般
やまだゆうじ	山田雄士	固有一般
やまだゆうや	山田裕也	固有一般
やまだよしふみ	山田祥史	固有一般
やまだりく	山田陸	固有一般
やまだりく	山田理矩	固有一般
やまだりょうせい	山田凌聖	固有一般
やまとかいり	大和海里	固有一般
やまとてつ	大和哲	固有一般
やまとはるき	大和陽希	固有一般
やまとゆづき	大和優槻	固有一般
やまとれん	大和蓮	固有一般
やまなかあつき	山中惇希	固有一般
やまなかけんた	山中健太	固有一般
やまなかしゅうせい	山中柊生	固有一般
やまなかせいこう	山中誠晃	固有一般
やまなかりょうじ	山中良二	固有一般
やまなかりょうすけ	山中亮輔	固有一般
やまなかれお	山中麗央	固有一般
やまにしたかひろ	山西尊裕	固有一般
やまねいわお	山根巌	固有一般
やまねけんせい	山根顕星	固有一般
やまねとわ	山根永遠	固有一般
やまねなお	山根成陽	固有一般
やまねみき	山根視来	固有一般
やまねりく	山根陸	固有一般
やまのはる	山野悠	固有一般
やまのいたくみ	山ノ井拓己	固有一般
やまのうちゆうき	山之内優貴	固有一般
やまはしたかし	山橋貴史	固有一般
やまはらこうたろう	山原康太郎	固有一般
やまはられおん	山原怜音	固有一般
やまふじけんた	山藤健太	固有一般
やまべたつき	山邊樹	固有一般
やまみひろと	山見大登	固有一般
やまみちこうへい	山道高平	固有一般
やまみちじゅんじ	山道淳司	固有一般
やまむらかずや	山村和也	固有一般
やまむらひろと	山村博土	固有一般
やまむらやすひろ	山村泰弘	固有一般
やまむらゆうき	山村佑樹	固有一般
やまもとあやと	山本彩斗	固有一般
やまもといさむ	山本勇武	固有一般
やまもといちや	山本一哉	固有一般
やまもとおおた	山本桜大	固有一般
やまもとかいと	山本海人	固有一般
やまもとかえで	山本楓	固有一般
やまもとけんじ	山本健二	固有一般
やまもとけんじ	山本健司	固有一般
やまもとこうすけ	山本康裕	固有一般
やまもとこうへい	山本孝平	固有一般
やまもとしゅうと	山本脩斗	固有一般
やまもとしゅんすけ	山本隼輔	固有一般
やまもとしゅんすけ	山本駿亮	固有一般
やまもとしょうたろう	山本将太郎	固有一般
やまもとしょうへい	山本翔平	固有一般
やまもとじょうい	山本丈偉	固有一般
やまもとそうたろう	山本宗太朗	固有一般
やまもとたくや	山本拓弥	固有一般
やまもとたいき	山本大稀	固有一般
やまもととうい	山本透衣	固有一般
やまもとのりみち	山本義道	固有一般
やまもとひでおみ	山本英臣	固有一般
やまもとひなた	山本陽大	固有一般
やまもとひろき	山本大貴	固有一般
やまもとひろき	山本祥輝	固有一般
やまもとひろと	山本啓人	固有一般
やまもとひろまさ	山本浩正	固有一般
やまもとふじお	山本富士雄	固有一般
やまもとまさき	山本真希	固有一般
やまもとまさや	山本真也	固有一般
やまもとゆうき	山本悠樹	固有一般
やまもとよしき	山本祥輝	固有一般
やまもとりひと	山本理仁	固有一般
やまもとりゅうへい	山本龍平	固有一般
やまもとりょうたろう	山本凌太郎	固有一般
やまもとりん	山本凜	固有一般
やまもとれん	山本蓮	固有一般
やまもとれん	山本廉	固有一般
やまやゆうし	山谷侑士	固有一般
やまわきかおる	山脇樺織	固有一般
やむらけん	矢村健	固有一般
やりみずそま	鑓水壮真	固有一般
やりみずりょうせい	鑓水澪星	固有一般
やんふぁん	楊帆	固有一般
ゆさんちゅる	柳想鐵	固有一般
ゆじは	柳知廈	固有一般
ゆひょうじん	劉孝眞	固有一般
ゆあされお	湯浅礼生	固有一般
ゆいこうた	由井航太	固有一般
ゆうきこうぞう	結城耕造	固有一般
てらだゆうさく	寺田優作	固有一般
ゆままさや	遊馬将也	固有一般
ゆきえひろと	雪江悠人	固有一般
ゆくともとき	行友翔哉	固有一般
ゆげつばさ	弓削翼	固有一般
ゆさかつみ	遊佐克美	固有一般
ゆざわたくし	湯澤拓士	固有一般
ゆざわまさと	湯澤聖人	固有一般
ゆざわようすけ	湯澤洋介	固有一般
ゆだかい	湯田海	固有一般
ゆはらたけあき	油原丈著	固有一般
ゆみさききょうへい	弓崎恭平	固有一般
ゆみばまさき	弓場将輝	固有一般
ゆもとそうや	湯本創也	固有一般
ゆるきこうや	汰木康也	固有一般
ゆんじょんふぁん	尹晶煥	固有一般
ゆんちゃんす	尹昌洙	固有一般
ゆさんぶん	余善文	固有一般
よすんはえ	呂 成海	固有一般
よひょうじん	余孝珍	固有一般
よかみきお	養日幹大	固有一般
よだゆういち	要田勇一	固有一般
よつまさき	養津正樹	固有一般
よこうちあきのぶ	横内昭展	固有一般
よこかわあさひ	横川旦陽	固有一般
よこかわいずみ	横川泉	固有一般
よこぜきこういち	横関浩一	固有一般
よこたしょうや	横田翔也	固有一般
よこただいすけ	横田大祐	固有一般
よこたけつばさ	横竹翔	固有一般
よこたにしげる	横谷繁	固有一般
よこのじゅんき	横野純貴	固有一般
よこみぞこうた	横溝広太	固有一般
よこやまあきゆき	横山暁之	固有一般
よこやまあゆむ	横山歩夢	固有一般
よこやまさとし	横山聡	固有一般
よこやましゅんすけ	横山俊介	固有一般
よこやましょうだい	横山翔大	固有一般
よこやましょうへい	横山翔平	固有一般
よこやまじょい	横山序生	固有一般
よこやまそうた	横山聡太	固有一般
よこやまたかゆき	横山貴之	固有一般
よこやまたくじ	横山卓司	固有一般
よこやまたくや	横山拓也	固有一般
よこやまとものぶ	横山知伸	固有一般
よこやまともや	横山智也	固有一般
よこやまなおき	横山尚貴	固有一般
よこやまひろとし	横山博敏	固有一般
よこやまゆうじ	横山雄次	固有一般
よこやまゆめき	横山夢樹	固有一般
よこやまるい	横山塁	固有一般
よしいこうすけ	吉井孝輔	固有一般
よしいたいき	吉井泰生	固有一般
よしいたくま	吉井拓真	固有一般
よしいなおと	吉井直人	固有一般
よしいゆうすけ	吉井佑将	固有一般
よしおかいな	吉尾海夏	固有一般
よしおかけいた	喜岡佳太	固有一般
よしおかこうへい	吉岡航平	固有一般
よしおかさとし	吉岡聡	固有一般
よしおかひでき	吉岡秀樹	固有一般
よしおかまさかず	吉岡雅和	固有一般
よしかわきょうすけ	吉川京輔	固有一般
よしかわけんた	吉川健太	固有一般
よしかわこた	吉川虎王達	固有一般
よしかわしょうご	吉川翔梧	固有一般
よしかわたくや	吉川拓也	固有一般
よしかわなおき	吉川直輝	固有一般
よしざきかつや	吉嵜勝哉	固有一般
よしざきひろのぶ	吉崎弘宣	固有一般
よしざきゆうすけ	吉崎雄亮	固有一般
よしざわしゅう	吉澤柊	固有一般
よしざわしょうたろう	義澤将太郎	固有一般
よしざわみらい	吉沢実頼	固有一般
よしざわゆうき	義澤侑樹	固有一般
よしざわゆうや	吉澤佑哉	固有一般
よしたけつよし	吉武剛	固有一般
よしたけりお	吉武莉央	固有一般
よしたにきずな	芳谷絆	固有一般
よしだあきお	吉田明生	固有一般
よしだあきひろ	吉田明博	固有一般
よしだあきよし	吉田顕清	固有一般
よしだあきら	吉田晃	固有一般
よしだあらた	吉田新	固有一般
よしだいぶき	吉田伊吹	固有一般
よしだかずき	吉田和暉	固有一般
よしだけんたろう	吉田賢太郎	固有一般
よしだげんたろう	吉田源太郎	固有一般
よしだこうき	吉田光希	固有一般
よしださちお	吉田幸生	固有一般
よしださとし	吉田智志	固有一般
よしださとる	吉田悟	固有一般
よしだしゅん	吉田舜	固有一般
よしだしゅん	吉田峻	固有一般
よしだじんぺい	吉田陣平	固有一般
よしだたいじゅ	吉田泰授	固有一般
よしだたかゆき	吉田孝行	固有一般
よしだたつま	吉田達磨	固有一般
よしだとおる	吉田暢	固有一般
よしだともき	吉田知樹	固有一般
よしだともひさ	吉田智尚	固有一般
よしだともやす	吉田朋恭	固有一般
よしだないと	吉田騎	固有一般
よしだなおや	吉田直矢	固有一般
よしだはやて	吉田颯	固有一般
よしだはるき	吉田晴稀	固有一般
よしだはるき	吉田温紀	固有一般
よしだひかる	吉田光	固有一般
よしだひろまさ	芳田大将	固有一般
よしだひろゆき	吉田裕幸	固有一般
よしだまきと	吉田眞紀人	固有一般
よしだまさき	吉田正樹	固有一般
よしだまさふみ	吉田真史	固有一般
よしだまさや	吉田将也	固有一般
よしだまさよし	吉田匡良	固有一般
よしだまなと	吉田真那斗	固有一般
よしだまや	吉田麻也	固有一般
よしだみつのり	吉田光範	固有一般
よしだみなと	吉田実成都	固有一般
よしだめぐむ	吉田恵	固有一般
よしだむねひろ	吉田宗弘	固有一般
よしだやすたか	吉田安孝	固有一般
よしだやすひろ	吉田康弘	固有一般
よしだゆいと	吉田唯人	固有一般
よしだゆうじ	吉田有志	固有一般
よしだゆうたろう	吉田雄汰朗	固有一般
よしだゆづき	吉田柚輝	固有一般
よしだゆたか	吉田豊	固有一般
よしだらいき	吉田来綺	固有一般
よしとみしゅんすけ	吉富駿介	固有一般
よしなおだいと	吉直大翔	固有一般
よしながしょい	吉永昇偉	固有一般
よしながたかまさ	吉永孝政	固有一般
よしながひろし	吉永大志	固有一般
よしながまひろ	吉長真優	固有一般
よしなりこうじ	吉成浩司	固有一般
よしなりはると	吉成遥斗	固有一般
よしなれたかや	吉馴空矢	固有一般
よしのきょうへい	吉野恭平	固有一般
よしのたかみつ	吉野峻光	固有一般
よしのともゆき	吉野智行	固有一般
よしのはると	吉野陽翔	固有一般
よしのゆうたろう	吉野裕太郎	固有一般
よしのよしき	吉野喜貴	固有一般
よしはまりょうへい	吉濱遼平	固有一般
よしはらこうた	吉原宏太	固有一般
よしはらしゅうすけ	吉原秀祐	固有一般
よしはらしんや	吉原慎也	固有一般
よしはらたいと	吉原大登	固有一般
よしはらまさと	吉原正人	固有一般
よしはらゆうき	吉原優輝	固有一般
よしひらつばさ	吉平翼	固有一般
よしひろみつゆき	吉弘充志	固有一般
よしまるけんしん	吉丸絢梓	固有一般
よしみいっせい	吉見一星	固有一般
よしみなつき	吉見夏樹	固有一般
よしみずいつき	吉水樹	固有一般
よしみつだいすけ	吉満大介	固有一般
よしむらぎんが	吉村銀河	固有一般
よしむらけいじ	吉村圭司	固有一般
よしむらこういち	吉村耕一	固有一般
よしむらこうじ	吉村光示	固有一般
よしむらとしひろ	吉村寿洋	固有一般
よしむらゆずる	吉村弦	固有一般
よしむられお	吉村伶雄	固有一般
よしもとあつし	吉本淳	固有一般
よしもとかずのり	吉本一謙	固有一般
よしもとくが	吉本空雅	固有一般
よしもとたかふみ	吉本岳史	固有一般
よしもとゆうき	吉本勇気	固有一般
よだみつまさ	依田光正	固有一般
よどかわせいじゅ	淀川誠珠	固有一般
よなしろともき	与那城智希	固有一般
よなはこうわ	与那覇航和	固有一般
よねくらこき	米倉恒貴	固有一般
よねくらまこと	米倉誠	固有一般
よねざわたけし	米澤剛志	固有一般
よねざわてつや	米澤哲哉	固有一般
よねざわれい	米澤令衣	固有一般
よねだしゅんや	米田隼也	固有一般
よねはらしゅうすけ	米原秀亮	固有一般
よねはらゆう	米原祐	固有一般
よねもとたくじ	米本拓司	固有一般
よねやまあつし	米山篤志	固有一般
よねやまさとし	米山智	固有一般
よねやまだいすけ	米山大輔	固有一般
よねやまりゅういち	米山隆一	固有一般
よめさかしょうた	嫁阪翔太	固有一般
よりいけん	寄井憲	固有一般
らくやまたかし	楽山孝志	固有一般
らもするい	ラモス瑠偉	固有一般
りきょんじゅ	李京樹	固有一般
りただなり	李忠成	固有一般
りちぇぐん	李在根	固有一般
りちゃんお	李将吾	固有一般
りちゃんがん	李彰剛	固有一般
りちゃんす	李将樹	固有一般
りかんせい	李漢宰	固有一般
りよんじき	李栄直	固有一般
りきやすしょうご	力安祥伍	固有一般
りょうひょんじゅ	梁賢柱	固有一般
りょうよんぎ	梁勇基	固有一般
りょうひろと	梁大翔	固有一般
りんどうまこと	林堂眞	固有一般
りゅしゅうあん	呂薛安	固有一般
ろくたんゆうじ	六反勇治	固有一般
わかいけんじ	若井研治	固有一般
わかさまさし	若狭大志	固有一般
わかさゆうじ	輪笠祐士	固有一般
わかすぎこうき	若杉好輝	固有一般
わかすぎたくや	若杉拓哉	固有一般
わかつきやまと	若月大和	固有一般
わかはらともや	若原智哉	固有一般
わかばやしまなふ	若林学歩	固有一般
わかばやしまなぶ	若林学	固有一般
わかばやしらいや	若林頼以弥	固有一般
わかばやしりゅう	若林龍	固有一般
わかまつけんじ	若松けん将	固有一般
わかまつだいき	若松大樹	固有一般
わかやたくみ	若谷拓海	固有一般
わきひろき	脇裕基	固有一般
わきざかやすと	脇坂泰斗	固有一般
わきざかりょうへい	脇坂崚平	固有一般
わきたにしずか	脇谷静香	固有一般
わきもとこうせい	脇本晃成	固有一般
わくたくみ	和久匠	固有一般
わくいとしひろ	涌井寿大	固有一般
わけしまゆたか	分島諒	固有一般
わこなおき	輪湖直樹	固有一般
わしだまさかず	鷲田雅一	固有一般
わたいまさき	渡井理己	固有一般
わただみつとし	和多田充寿	固有一般
わたなべあつお	渡辺敦夫	固有一般
わたなべあらた	渡邉新太	固有一般
わたなべいっぺい	渡辺一平	固有一般
わたなべえいすけ	渡邉英祐	固有一般
わたなべおだい	渡辺桜大	固有一般
わたなべかいと	渡邉海翔	固有一般
わたなべかいと	渡部快斗	固有一般
わたなべかずひと	渡邊一仁	固有一般
わたなべかずま	渡邉千真	固有一般
わたなべけいか	渡邊啓佳	固有一般
わたなべけいじ	渡邊圭二	固有一般
わたなべけんた	渡辺健太	固有一般
わたなべこうた	渡辺皓太	固有一般
わたなべこうだい	渡辺広大	固有一般
わたなべしもん	渡邉志門	固有一般
わたなべしゅうと	渡邉柊斗	固有一般
わたなべしゅや	渡辺嵩也	固有一般
わたなべじゅんいち	渡辺淳一	固有一般
わたなべすすむ	渡辺晋	固有一般
わたなべそうた	渡邊創太	固有一般
わたなべたいき	渡邊泰基	固有一般
わたなべたいじゅ	渡部大樹	固有一般
わたなべたかまさ	渡辺隆正	固有一般
わたなべたく	渡辺卓	固有一般
わたなべたく	渡辺拓	固有一般
わたなべたくみ	渡辺匠	固有一般
わたなべたけし	渡辺毅	固有一般
わたなべだいごう	渡邉大剛	固有一般
わたなべつよし	渡辺剛	固有一般
わたなべてった	渡辺哲多	固有一般
わたなべともき	渡邊知生	固有一般
わたなべとるく	渡部飛駆	固有一般
わたなべなおき	渡邉尚樹	固有一般
わたなべなつひこ	渡辺夏彦	固有一般
わたなべひでとよ	渡邉英豊	固有一般
わたなべひろふみ	渡部博文	固有一般
わたなべひろや	渡部広也	固有一般
わたなべまこと	渡辺誠	固有一般
わたなべまさき	渡邉将基	固有一般
わたなべまさとも	渡邉真智	固有一般
わたなべまなぶ	渡部学	固有一般
わたなべまひろ	渡邊真宏	固有一般
わたなべみつき	渡邉三城	固有一般
わたなべみつてる	渡辺光輝	固有一般
わたなべやすひろ	渡辺泰広	固有一般
わたなべゆうが	渡辺悠雅	固有一般
わたなべよう	渡辺陽	固有一般
わたなべよしたか	渡辺佳孝	固有一般
わたなべりう	渡邉吏海	固有一般
わたなべりき	渡辺力樹	固有一般
わたなべりゅうと	渡部琉翔	固有一般
わたなべりょう	渡邉りょう	固有一般
わたなべりょう	渡邊龍	固有一般
わたなべりょうた	渡辺亮太	固有一般
わたなべりょうま	渡邊凌磨	固有一般
わたひきこう	綿引康	固有一般
わたべあれき	渡部一歴	固有一般
わたべだいすけ	渡部大輔	固有一般
わたりだいき	渡大生	固有一般
わだあつき	和田篤紀	固有一般
わだかんた	和田幹大	固有一般
わだきらと	和田輝斗	固有一般
わだけんたろう	和田健太郎	固有一般
わだこうせい	和田晃生	固有一般
わだじゅん	和田潤	固有一般
わだたくみ	和田拓三	固有一般
わだたくや	和田拓也	固有一般
わだたつや	和田達也	固有一般
わだともき	和田倫季	固有一般
わだはぐみ	和田育	固有一般
わだはる	和田悠	固有一般
わだひびき	和田響稀	固有一般
わだまさし	和田昌士	固有一般
わだまさひろ	和田昌裕	固有一般
わだゆうき	和田侑樹	固有一般
わだゆうせい	和田悠青	固有一般
わだゆうぞう	和田雄三	固有一般
わだりょう	和田凌	固有一般
わなみともひろ	和波智広	固有一般
わんしょうほう	王暁峰	固有一般
わんじんびん	王靖斌	固有一般
わんじあん	王嘉楠	固有一般