!!ATOK_TANGO_TEXT_HEADER_1
あいたつや	阿井達也	固有一般
たつや	達也	固有人名
あいかわしんや	相川進也	固有一般
しんや	進也	固有人名
あいざわしょうた	相澤祥太	固有一般
しょうた	祥太	固有人名
あいざわたかし	相澤貴志	固有一般
たかし	貴志	固有人名
あいざわぴーたーこあみ	相澤ピーターコアミ	固有一般
ぴーたーこあみ	ピーターコアミ	固有人名
あいざわゆうや	相澤佑哉	固有一般
ゆうや	佑哉	固有人名
あいだゆうき	相田勇樹	固有一般
ゆうき	勇樹	固有人名
あいづゆうき	会津雄生	固有一般
ゆうき	雄生	固有人名
あいはらしょうへい	粟飯原尚平	固有一般
しょうへい	尚平	固有人名
あいばみずき	饗庭瑞生	固有一般
みずき	瑞生	固有人名
あえこういち	阿江孝一	固有一般
こういち	孝一	固有人名
あおえしゅんすけ	青江俊祐	固有一般
しゅんすけ	俊祐	固有人名
あおきありま	青木安里磨	固有一般
ありま	安里磨	固有人名
あおきこうた	青木孝太	固有一般
こうた	孝太	固有人名
あおきこころ	青木心	固有一般
こころ	心	固有人名
あおきしゅんた	青木駿汰	固有一般
しゅんた	駿汰	固有人名
あおきしょう	青木捷	固有一般
しょう	捷	固有人名
あおきしょうた	青木翔大	固有一般
しょうた	翔大	固有人名
あおきそうま	青木想真	固有一般
そうま	想真	固有人名
あおきたくま	青木拓真	固有一般
たくま	拓真	固有人名
あおきたくや	青木拓矢	固有一般
たくや	拓矢	固有人名
あおきたけし	青木剛	固有一般
たけし	剛	固有人名
あおきつばさ	青木翼	固有一般
つばさ	翼	固有人名
あおきはやと	青木駿人	固有一般
はやと	駿人	固有人名
あおきひろと	青木洋翔	固有一般
ひろと	洋翔	固有人名
あおきまさむね	青木正宗	固有一般
まさむね	正宗	固有人名
あおきゆうすけ	青木友佑	固有一般
ゆうすけ	友佑	固有人名
あおきよしたか	青木義孝	固有一般
よしたか	義孝	固有人名
あおきりく	青木陸	固有一般
りく	陸	固有人名
あおきりょうた	青木亮太	固有一般
りょうた	亮太	固有人名
あおきりょうた	青木良太	固有一般
りょうた	良太	固有人名
あおしまたいち	青島太一	固有一般
たいち	太一	固有人名
あおしまたくま	青島拓馬	固有一般
たくま	拓馬	固有人名
あおしまふみあき	青嶋文明	固有一般
ふみあき	文明	固有人名
あおしまゆうや	青嶋佑弥	固有一般
ゆうや	佑弥	固有人名
あおたしょう	青田翔	固有一般
しょう	翔	固有人名
あおとかける	青戸翔	固有一般
かける	翔	固有人名
あおのいぶき	青野聖樹	固有一般
いぶき	聖樹	固有人名
あおのだいすけ	青野大介	固有一般
だいすけ	大介	固有人名
あおばゆきひろ	青葉幸洋	固有一般
ゆきひろ	幸洋	固有人名
あおやぎごう	青柳仰	固有一般
ごう	仰	固有人名
あおやまいきる	青山生	固有一般
いきる	生	固有人名
あおやまじゅん	青山隼	固有一般
じゅん	隼	固有人名
あおやまとしひろ	青山敏弘	固有一般
としひろ	敏弘	固有人名
あおやまなおあき	青山直晃	固有一般
なおあき	直晃	固有人名
あおやまひろあき	青山景昌	固有一般
ひろあき	景昌	固有人名
あおやまゆうすけ	青山夕祐	固有一般
ゆうすけ	夕祐	固有人名
あかいしゅういち	赤井秀一	固有一般
しゅういち	秀一	固有人名
あかいひでゆき	赤井秀行	固有一般
ひでゆき	秀行	固有人名
あかおあきら	赤尾公	固有一般
あきら	公	固有人名
あかおよしのぶ	赤尾佳宣	固有一般
よしのぶ	佳宣	固有人名
あかぎなおと	赤木直人	固有一般
なおと	直人	固有人名
あかぎはると	赤木陽翔	固有一般
はると	陽翔	固有人名
あかさかけいや	赤坂渓也	固有一般
けいや	渓也	固有人名
あかさきしゅうへい	赤﨑秀平	固有一般
しゅうへい	秀平	固有人名
あかすまなと	赤須真登	固有一般
まなと	真登	固有人名
あかつかみかえる	赤塚ミカエル	固有一般
みかえる	ミカエル	固有人名
あかつかれい	赤塚怜	固有一般
れい	怜	固有人名
あかほしかいま	赤星魁麻	固有一般
かいま	魁麻	固有人名
あかほしたかふみ	赤星貴文	固有一般
たかふみ	貴文	固有人名
あかほしたく	赤星拓	固有一般
たく	拓	固有人名
あかほしゆうすけ	赤星雄祐	固有一般
ゆうすけ	雄祐	固有人名
あかまつしゅうや	赤松秀哉	固有一般
しゅうや	秀哉	固有人名
あかみねしんご	赤嶺真吾	固有一般
しんご	真吾	固有人名
あきぎんじ	安芸銀治	固有一般
ぎんじ	銀治	固有人名
あきまさとし	安藝正俊	固有一般
まさとし	正俊	固有人名
あきしげりんたろう	秋重凛太朗	固有一般
りんたろう	凛太朗	固有人名
あきたひでよし	秋田英義	固有一般
ひでよし	英義	固有人名
あきたまさてる	秋田政輝	固有一般
まさてる	政輝	固有人名
あきたみずき	秋田深月	固有一般
みずき	深月	固有人名
あきたゆたか	秋田豊	固有一般
ゆたか	豊	固有人名
あきのひろき	秋野央樹	固有一般
ひろき	央樹	固有人名
あきばただひろ	秋葉忠宏	固有一般
ただひろ	忠宏	固有人名
あきばのぶひで	秋葉信秀	固有一般
のぶひで	信秀	固有人名
あきばまさる	秋葉勝	固有一般
まさる	勝	固有人名
あきばよういち	秋葉陽一	固有一般
よういち	陽一	固有人名
あきばりゅうじ	秋葉竜児	固有一般
りゅうじ	竜児	固有人名
あきもとたかひろ	明本考浩	固有一般
たかひろ	考浩	固有人名
あきもとまさひろ	秋元雅博	固有一般
まさひろ	雅博	固有人名
あきもとみちたか	秋本倫孝	固有一般
みちたか	倫孝	固有人名
あきもとようた	秋元陽太	固有一般
ようた	陽太	固有人名
あきもりれん	秋守蓮	固有一般
れん	蓮	固有人名
あきやましゅん	秋山駿	固有一般
しゅん	駿	固有人名
あきやまたかし	秋山貴嗣	固有一般
たかし	貴嗣	固有人名
あきやまたくや	秋山拓也	固有一般
たくや	拓也	固有人名
あきやまだいち	秋山大地	固有一般
だいち	大地	固有人名
あきやまとらのすけ	秋山虎之亮	固有一般
とらのすけ	虎之亮	固有人名
あきやまひろき	秋山裕紀	固有一般
ひろき	裕紀	固有人名
あきやまようすけ	秋山陽介	固有一般
ようすけ	陽介	固有人名
あきよしたいすけ	秋吉泰佑	固有一般
たいすけ	泰佑	固有人名
あけひともひろ	明比友宏	固有一般
ともひろ	友宏	固有人名
あげいしるい	揚石琉生	固有一般
るい	琉生	固有人名
あげつましゅうと	揚妻秀斗	固有一般
しゅうと	秀斗	固有人名
あさいかずき	浅井一希	固有一般
かずき	一希	固有人名
あさいかずひこ	浅井一彦	固有一般
かずひこ	一彦	固有人名
あさいかんた	浅井寛大	固有一般
かんた	寛大	固有人名
あさいこうすけ	浅井昂介	固有一般
こうすけ	昂介	固有人名
あさいとしみつ	浅井俊光	固有一般
としみつ	俊光	固有人名
あさかわはやと	浅川隼人	固有一般
はやと	隼人	固有人名
あさかわまさき	浅川将輝	固有一般
まさき	将輝	固有人名
あさくらそう	朝倉爽	固有一般
そう	爽	固有人名
あさくらのりあき	朝倉徳明	固有一般
のりあき	徳明	固有人名
あさくられん	浅倉廉	固有一般
れん	廉	固有人名
あさだしょうご	麻田将吾	固有一般
しょうご	将吾	固有人名
あさだだいき	浅田大樹	固有一般
だいき	大樹	固有人名
あさぬますぐる	浅沼優瑠	固有一般
すぐる	優瑠	固有人名
あさぬまたつや	浅沼達也	固有一般
あさのかおる	浅野薫	固有一般
かおる	薫	固有人名
あさのかつき	浅野克己	固有一般
かつき	克己	固有人名
あさのたくま	浅野拓磨	固有一般
たくま	拓磨	固有人名
あさのてつや	浅野哲也	固有一般
てつや	哲也	固有人名
あさのなおき	浅野直希	固有一般
なおき	直希	固有人名
あさのゆうや	浅野雄也	固有一般
ゆうや	雄也	固有人名
あさひだいすけ	朝日大輔	固有一般
だいすけ	大輔	固有人名
あさひなしん	朝比奈伸	固有一般
しん	伸	固有人名
あさみともき	朝見友樹	固有一般
ともき	友樹	固有人名
あさりさとる	浅利悟	固有一般
さとる	悟	固有人名
あしのしょうと	芦野翔斗	固有一般
しょうと	翔斗	固有人名
あしべこうせい	芦部晃生	固有一般
こうせい	晃生	固有人名
あすけしょう	足助翔	固有一般
あずまけいご	東桂吾	固有一般
けいご	桂吾	固有人名
あずまひろき	東博樹	固有一般
ひろき	博樹	固有人名
あずまひろし	東浩史	固有一般
ひろし	浩史	固有人名
あそうしゅん	麻生瞬	固有一般
しゅん	瞬	固有人名
あだちかいと	足立快斗	固有一般
かいと	快斗	固有人名
あだちかずき	安達一貴	固有一般
かずき	一貴	固有人名
あだちけんたろう	安達健太郎	固有一般
けんたろう	健太郎	固有人名
あだちさく	安達朔	固有一般
さく	朔	固有人名
あだちしゅうと	安達秀都	固有一般
しゅうと	秀都	固有人名
あだちつばさ	足立翼	固有一般
あだちひろひで	足立丈英	固有一般
ひろひで	丈英	固有人名
あだちゆう	足立優	固有一般
ゆう	優	固有人名
あつかわのりまさ	熱川徳政	固有一般
のりまさ	徳政	固有人名
あつたまこと	熱田眞	固有一般
まこと	眞	固有人名
あつみえいすけ	渥美瑛亮	固有一般
えいすけ	瑛亮	固有人名
あずまひろまさ	吾妻弘将	固有一般
ひろまさ	弘将	固有人名
あのまひろ	阿野真拓	固有一般
まひろ	真拓	固有人名
あびこたかまさ	安彦考真	固有一般
たかまさ	考真	固有人名
あぴあたうぃあひさし	アピアタウィア久	固有一般
ひさし	久	固有人名
あぴっちあきら	アピッチ輝	固有一般
あきら	輝	固有人名
あべかいと	阿部海斗	固有一般
かいと	海斗	固有人名
あべかいと	阿部海大	固有一般
かいと	海大	固有人名
あべかずき	阿部一樹	固有一般
かずき	一樹	固有人名
あべかなと	阿部要門	固有一般
かなと	要門	固有人名
あべくうや	阿部空矢	固有一般
くうや	空矢	固有人名
あべけんさく	阿部謙作	固有一般
けんさく	謙作	固有人名
あべこうと	阿部航斗	固有一般
こうと	航斗	固有人名
あべしゅう	阿部嵩	固有一般
しゅう	嵩	固有人名
あべしゅうと	安部柊斗	固有一般
しゅうと	柊斗	固有人名
あべしょうへい	阿部翔平	固有一般
しょうへい	翔平	固有人名
あべたいせい	安部大晴	固有一般
たいせい	大晴	固有人名
あべたかし	安部崇士	固有一般
たかし	崇士	固有人名
あべたくま	阿部拓馬	固有一般
あべたくみ	阿部巧	固有一般
たくみ	巧	固有人名
あべてつや	阿部哲也	固有一般
あべとしゆき	阿部敏之	固有一般
としゆき	敏之	固有人名
あべのぶゆき	阿部伸行	固有一般
のぶゆき	伸行	固有人名
あべはやと	阿部隼人	固有一般
あべはると	阿部遥人	固有一般
はると	遥人	固有人名
あべひかる	阿部輝	固有一般
ひかる	輝	固有人名
あべひろき	安部裕葵	固有一般
ひろき	裕葵	固有人名
あべひろゆき	阿部浩之	固有一般
ひろゆき	浩之	固有人名
あべぶんいちろう	阿部文一朗	固有一般
ぶんいちろう	文一朗	固有人名
あべまさのり	阿部正紀	固有一般
まさのり	正紀	固有人名
あべまひろ	阿部真尋	固有一般
まひろ	真尋	固有人名
あべみなほ	阿部水帆	固有一般
みなほ	水帆	固有人名
あべゆういち	安部雄一	固有一般
ゆういち	雄一	固有人名
あべゆうき	阿部勇樹	固有一般
あべゆうき	阿部優	固有一般
ゆうき	優	固有人名
あべゆうた	安部雄大	固有一般
ゆうた	雄大	固有人名
あべゆうたろう	阿部祐大朗	固有一般
ゆうたろう	祐大朗	固有人名
あべよしのり	阿部良則	固有一般
よしのり	良則	固有人名
あべよしろう	阿部吉朗	固有一般
よしろう	吉朗	固有人名
あべらいせい	阿部来誠	固有一般
らいせい	来誠	固有人名
あべりゅうのすけ	阿部龍之介	固有一般
りゅうのすけ	龍之介	固有人名
あべりょうや	阿部諒弥	固有一般
りょうや	諒弥	固有人名
あまがさたいき	天笠泰輝	固有一般
たいき	泰輝	固有人名
あまねゆうき	天根勇輝	固有一般
ゆうき	勇輝	固有人名
あまのこうた	天野恒太	固有一般
こうた	恒太	固有人名
あまのじゅん	天野純	固有一般
じゅん	純	固有人名
あまのたかし	天野貴史	固有一般
たかし	貴史	固有人名
あまのゆうき	天野悠貴	固有一般
ゆうき	悠貴	固有人名
あまのゆうしん	天野友心	固有一般
ゆうしん	友心	固有人名
あまのりゅうせい	天野瑠成	固有一般
りゅうせい	瑠成	固有人名
あもうりょうすけ	天羽良輔	固有一般
りょうすけ	良輔	固有人名
あゆかわしゅん	鮎川峻	固有一般
しゅん	峻	固有人名
あらたかふみ	荒貴史	固有一般
たかふみ	貴史	固有人名
あらいいっき	新井一耀	固有一般
いっき	一耀	固有人名
あらいかいせい	荒井海聖	固有一般
かいせい	海聖	固有人名
あらいかんた	荒井貫太	固有一般
かんた	貫太	固有人名
あらいけんじ	新井健二	固有一般
けんじ	健二	固有人名
あらいしゅうが	荒井秀賀	固有一般
しゅうが	秀賀	固有人名
あらいしょうた	新井章太	固有一般
しょうた	章太	固有人名
あらいしょうた	新井翔太	固有一般
しょうた	翔太	固有人名
あらいじゅんぺい	新井純平	固有一般
じゅんぺい	純平	固有人名
あらいたいき	新井泰貴	固有一般
たいき	泰貴	固有人名
あらいたつのり	新居辰基	固有一般
たつのり	辰基	固有人名
あらいたつや	新井辰也	固有一般
たつや	辰也	固有人名
あらいなおと	新井直登	固有一般
なおと	直登	固有人名
あらいなおと	新井直人	固有一般
あらいはやと	新井隼利	固有一般
はやと	隼利	固有人名
あらいはるき	新井晴樹	固有一般
はるき	晴樹	固有人名
あらいひかる	新井光	固有一般
ひかる	光	固有人名
あらいひであき	新井秀明	固有一般
ひであき	秀明	固有人名
あらいひろと	新井博人	固有一般
ひろと	博人	固有人名
あらいみきひと	新井幹人	固有一般
みきひと	幹人	固有人名
あらいみずき	新井瑞希	固有一般
みずき	瑞希	固有人名
あらいゆうた	新井悠太	固有一般
ゆうた	悠太	固有人名
あらいゆうた	荒井悠汰	固有一般
ゆうた	悠汰	固有人名
あらいよしあき	新井栄聡	固有一般
よしあき	栄聡	固有人名
あらいりょうへい	新井涼平	固有一般
りょうへい	涼平	固有人名
あらいばとおる	新井場徹	固有一般
とおる	徹	固有人名
あらかきたかゆき	新垣貴之	固有一般
たかゆき	貴之	固有人名
あらかわそうま	荒川颯磨	固有一般
そうま	颯磨	固有人名
あらかわとわ	荒川永遠	固有一般
とわ	永遠	固有人名
あらきけんと	荒木健斗	固有一般
けんと	健斗	固有人名
あらきしゅうた	荒木秀太	固有一般
しゅうた	秀太	固有人名
あらきしゅんた	荒木駿汰	固有一般
あらきしゅんた	荒木駿太	固有一般
しゅんた	駿太	固有人名
あらきしょう	荒木翔	固有一般
あらきだいご	荒木大吾	固有一般
だいご	大吾	固有人名
あらきはやと	荒木隼人	固有一般
あらきりょうすけ	荒木亮輔	固有一般
りょうすけ	亮輔	固有人名
あらきりょうた	荒木遼太	固有一般
りょうた	遼太	固有人名
あらきりょうたろう	荒木遼太郎	固有一般
りょうたろう	遼太郎	固有人名
あらきるい	荒木琉偉	固有一般
るい	琉偉	固有人名
あらたしげき	荒田成貴	固有一般
しげき	成貴	固有人名
あらたともゆき	荒田智之	固有一般
ともゆき	智之	固有人名
あらたにひろき	荒谷弘樹	固有一般
ひろき	弘樹	固有人名
あらたまえいる	新玉瑛琉	固有一般
えいる	瑛琉	固有人名
あらのたくま	荒野拓馬	固有一般
あらぼりけんじ	荒堀謙次	固有一般
けんじ	謙次	固有人名
ありしまなお	有島那音	固有一般
なお	那音	固有人名
ありぞのしんご	有薗真吾	固有一般
ありたけいと	有田恵人	固有一般
けいと	恵人	固有人名
ありたこうき	有田光希	固有一般
こうき	光希	固有人名
ありたりょう	有田稜	固有一般
りょう	稜	固有人名
ありながかずき	有永一生	固有一般
かずき	一生	固有人名
ありまけんじ	有馬賢二	固有一般
けんじ	賢二	固有人名
ありまげんき	有馬弦希	固有一般
げんき	弦希	固有人名
ありまこうたろう	有馬幸太郎	固有一般
こうたろう	幸太郎	固有人名
ありまじゅん	有間潤	固有一般
じゅん	潤	固有人名
ありみずあき	有水亮	固有一般
あき	亮	固有人名
ありみつくひろ	有光空大	固有一般
くひろ	空大	固有人名
ありみつりょうた	有光亮太	固有一般
ありむらこうじ	有村光史	固有一般
こうじ	光史	固有人名
ありむらしゅうと	有村柊人	固有一般
しゅうと	柊人	固有人名
あわかしゅんた	阿波加俊太	固有一般
しゅんた	俊太	固有人名
あわたりしんや	阿渡真也	固有一般
しんや	真也	固有人名
あわのけんと	粟野健翔	固有一般
けんと	健翔	固有人名
あんじゅんそ	安 俊洙	固有一般
あんじょんふぁん	安貞桓	固有一般
じょんふぁん	貞桓	固有人名
あんそんじん	安鮮鎮	固有一般
そんじん	鮮鎮	固有人名
あんひょよん	安孝錬	固有一般
ひょよん	孝錬	固有人名
あんびょんじゅん	安柄俊	固有一般
びょんじゅん	柄俊	固有人名
あんよんう	安庸佑	固有一般
よんう	庸佑	固有人名
あんよんはく	安 英学	固有一般
あんざいかいと	安西海斗	固有一般
あんざいかずき	安在和樹	固有一般
かずき	和樹	固有人名
あんざいこうき	安西幸輝	固有一般
こうき	幸輝	固有人名
あんざいそうま	安斎颯馬	固有一般
そうま	颯馬	固有人名
あんざいたつや	安在達弥	固有一般
たつや	達弥	固有人名
あんだらい	按田頼	固有一般
らい	頼	固有人名
あんどうあおい	安藤阿雄依	固有一般
あおい	阿雄依	固有人名
あんどうあきら	安東輝	固有一般
あんどうかずや	安藤一哉	固有一般
かずや	一哉	固有人名
あんどうこうせい	安藤虎星	固有一般
こうせい	虎星	固有人名
あんどうしゅんすけ	安藤駿介	固有一般
しゅんすけ	駿介	固有人名
あんどうしゅんや	安藤駿冶	固有一般
しゅんや	駿冶	固有人名
あんどうじゅん	安藤淳	固有一般
じゅん	淳	固有人名
あんどうだいすけ	安東大介	固有一般
あんどうつばさ	安藤翼	固有一般
あんどうてる	安東輝	固有一般
てる	輝	固有人名
あんどうとしき	安藤寿岐	固有一般
としき	寿岐	固有人名
あんどうともや	安藤智哉	固有一般
ともや	智哉	固有人名
あんどうともやす	安藤智安	固有一般
ともやす	智安	固有人名
あんどうなおと	安藤由翔	固有一般
なおと	由翔	固有人名
あんどうまさひろ	安藤正裕	固有一般
まさひろ	正裕	固有人名
あんどうみずき	安藤瑞季	固有一般
みずき	瑞季	固有人名
あんどうりゅうせい	安藤竜星	固有一般
りゅうせい	竜星	固有人名
あんらくけんた	安楽健太	固有一般
けんた	健太	固有人名
いがんじん	李 康珍	固有一般
いきじ	李 記帝	固有一般
いぐの	李根鎬	固有一般
ぐの	根鎬	固有人名
いじょんす	李  正秀	固有一般
いじょんみん	李鍾民	固有一般
じょんみん	鍾民	固有人名
いせうんひ	李 承熙	固有一般
いちゅんす	李天秀	固有一般
ちゅんす	天秀	固有人名
いどんみょん	李 東明	固有一般
いほう	李浩	固有一般
ほう	浩	固有人名
いほせうん	李 昊乗	固有一般
いみょんじゃ	李明載	固有一般
みょんじゃ	明載	固有人名
いいりょうま	伊井涼馬	固有一般
りょうま	涼馬	固有人名
いいおかずのり	飯尾一慶	固有一般
かずのり	一慶	固有人名
いいおかずや	飯尾和也	固有一般
かずや	和也	固有人名
いいおりゅうたろう	飯尾竜太朗	固有一般
りゅうたろう	竜太朗	固有人名
いいくらひろき	飯倉大樹	固有一般
ひろき	大樹	固有人名
いいけしょうご	伊池翔吾	固有一般
しょうご	翔吾	固有人名
いいじまかずひさ	飯島寿久	固有一般
かずひさ	寿久	固有人名
いいじまりく	飯島陸	固有一般
いいずみりょうや	飯泉涼矢	固有一般
りょうや	涼矢	固有人名
いいだしょうご	飯田正吾	固有一般
しょうご	正吾	固有人名
いいだたかひろ	飯田貴敬	固有一般
たかひろ	貴敬	固有人名
いいだたつみ	飯田健巳	固有一般
たつみ	健巳	固有人名
いいだひろたか	飯田絋孝	固有一般
ひろたか	絋孝	固有人名
いいだまさき	飯田真輝	固有一般
まさき	真輝	固有人名
いいだまさひろ	飯田雅浩	固有一般
まさひろ	雅浩	固有人名
いいだゆうじ	飯田優二	固有一般
ゆうじ	優二	固有人名
いいだりくと	飯田陸斗	固有一般
りくと	陸斗	固有人名
いいだりょう	飯田涼	固有一般
りょう	涼	固有人名
いいづかだいち	飯塚大地	固有一般
いいづかひろき	飯塚浩記	固有一般
ひろき	浩記	固有人名
いいづかよしひと	飯塚欣士	固有一般
よしひと	欣士	固有人名
いいのじゅお	飯野珠央	固有一般
じゅお	珠央	固有人名
いいのななせい	飯野七聖	固有一般
ななせい	七聖	固有人名
いいのまさとし	飯野雅俊	固有一般
まさとし	雅俊	固有人名
いいむらたいき	飯村太基	固有一般
たいき	太基	固有人名
いいむろりょうた	飯室綾太	固有一般
りょうた	綾太	固有人名
いいやまゆうご	飯山悠吾	固有一般
ゆうご	悠吾	固有人名
いえいずみれい	家泉怜依	固有一般
れい	怜依	固有人名
いえながあきひろ	家長昭博	固有一般
あきひろ	昭博	固有人名
いおかかいと	井岡海都	固有一般
かいと	海都	固有人名
いがらしあらた	五十嵐新	固有一般
あらた	新	固有人名
いかりあすま	碇明日麻	固有一般
あすま	明日麻	固有人名
いかりのかずま	碇野壱馬	固有一般
かずま	壱馬	固有人名
いかわはるき	井川晴貴	固有一般
はるき	晴貴	固有人名
いがらしえいと	五十嵐瑛都	固有一般
えいと	瑛都	固有人名
いがらしかいと	五十嵐海斗	固有一般
いがらしかずや	五十嵐和也	固有一般
いがらしたいよう	五十嵐太陽	固有一般
たいよう	太陽	固有人名
いがらしだいご	五十嵐大悟	固有一般
だいご	大悟	固有人名
いがらしまさと	五十嵐理人	固有一般
まさと	理人	固有人名
いがりあゆむ	猪狩歩望	固有一般
あゆむ	歩望	固有人名
いがりゆうき	猪狩佑貴	固有一般
ゆうき	佑貴	固有人名
いがわそら	井川空	固有一般
そら	空	固有人名
いがわゆうすけ	井川祐輔	固有一般
ゆうすけ	祐輔	固有人名
いきつしょうじ	生津将司	固有一般
しょうじ	将司	固有人名
いぐちりくと	井口綾人	固有一般
りくと	綾人	固有人名
いけうちともひこ	池内友彦	固有一般
ともひこ	友彦	固有人名
いけがみじょうじ	池上丈二	固有一般
じょうじ	丈二	固有人名
いけがみれいいち	池上礼一	固有一般
れいいち	礼一	固有人名
いけがやぎんじろう	池谷銀姿郎	固有一般
ぎんじろう	銀姿郎	固有人名
いけがやはやと	池ヶ谷颯斗	固有一般
はやと	颯斗	固有人名
いけたかのぶき	池髙暢希	固有一般
のぶき	暢希	固有人名
いけだけい	池田圭	固有一般
けい	圭	固有人名
いけだこう	池田航	固有一般
こう	航	固有人名
いけだしゅうじ	池田修志	固有一般
しゅうじ	修志	固有人名
いけだしゅんた	池田春汰	固有一般
しゅんた	春汰	固有人名
いけだしょうへい	池田昇平	固有一般
しょうへい	昇平	固有人名
いけだじゅらと	池田樹雷人	固有一般
じゅらと	樹雷人	固有人名
いけだたくみ	池田拓海	固有一般
たくみ	拓海	固有人名
いけだたつや	池田達哉	固有一般
たつや	達哉	固有人名
いけだとうや	池田任泰	固有一般
とうや	任泰	固有人名
いけだのぶやす	池田伸康	固有一般
のぶやす	伸康	固有人名
いけだふとし	池田太	固有一般
ふとし	太	固有人名
いけだほまれ	池田誉	固有一般
ほまれ	誉	固有人名
いけだまこと	池田誠	固有一般
まこと	誠	固有人名
いけだまさき	池田昌生	固有一般
まさき	昌生	固有人名
いけだまさひろ	池田昌広	固有一般
まさひろ	昌広	固有人名
いけだまなぶ	池田学	固有一般
まなぶ	学	固有人名
いけだまもる	池田衛	固有一般
まもる	衛	固有人名
いけだゆずき	池田柚生	固有一般
ゆずき	柚生	固有人名
いけだれん	池田廉	固有一般
いけながわたる	池永航	固有一般
わたる	航	固有人名
いけにわりょうや	池庭諒耶	固有一般
りょうや	諒耶	固有人名
いけのうえしゅんいち	池ノ上俊一	固有一般
しゅんいち	俊一	固有人名
いけはたようすけ	池端陽介	固有一般
いけまかなう	池間叶	固有一般
かなう	叶	固有人名
いけまつしゅんぺい	池末瞬平	固有一般
しゅんぺい	瞬平	固有人名
いけまつひであき	池松秀明	固有一般
いけもとともき	池元友樹	固有一般
いけもとはる	池本晴	固有一般
はる	晴	固有人名
いけもとゆう	池本優	固有一般
いけやともき	池谷友喜	固有一般
ともき	友喜	固有人名
いけやゆうすけ	池谷祐輔	固有一般
いこまけい	生駒稀生	固有一般
けい	稀生	固有人名
いこまじん	生駒仁	固有一般
じん	仁	固有人名
いさこうへい	伊佐耕平	固有一般
こうへい	耕平	固有人名
いさかけんた	井坂健太	固有一般
いさかてっぺい	井坂鉄平	固有一般
てっぺい	鉄平	固有人名
いざわあつし	井澤惇	固有一般
あつし	惇	固有人名
いざわしゅうと	伊澤翔登	固有一般
しゅうと	翔登	固有人名
いざわそうへい	伊澤壮平	固有一般
そうへい	壮平	固有人名
いざわはるき	井澤春輝	固有一般
はるき	春輝	固有人名
いしいかいせい	石井快征	固有一般
かいせい	快征	固有人名
いしいけいた	石井圭太	固有一般
けいた	圭太	固有人名
いしいけんご	石井謙伍	固有一般
けんご	謙伍	固有人名
いしいけんた	石井健太	固有一般
いしいこうき	石井光輝	固有一般
こうき	光輝	固有人名
いしいそうじろう	石井壯二郎	固有一般
そうじろう	壯二郎	固有人名
いしいたいせい	石井大生	固有一般
たいせい	大生	固有人名
いしいとしや	石井俊也	固有一般
としや	俊也	固有人名
いしいはやた	石井隼太	固有一般
はやた	隼太	固有人名
いしいひさつぐ	石井久継	固有一般
ひさつぐ	久継	固有人名
いしいひでのり	石井秀典	固有一般
ひでのり	秀典	固有人名
いしいひでゆき	石井秀幸	固有一般
ひでゆき	秀幸	固有人名
いしいひゅうま	石井飛雄馬	固有一般
ひゅうま	飛雄馬	固有人名
いしいまさただ	石井正忠	固有一般
まさただ	正忠	固有人名
いしいゆうすけ	石井雄輔	固有一般
ゆうすけ	雄輔	固有人名
いしいりゅうせい	石井琉晟	固有一般
りゅうせい	琉晟	固有人名
いしいりょう	石井僚	固有一般
りょう	僚	固有人名
いしいりょう	石井綾	固有一般
りょう	綾	固有人名
いしうらたいが	石浦大雅	固有一般
たいが	大雅	固有人名
いしおりくと	石尾陸登	固有一般
りくと	陸登	固有人名
いしおりょうが	石尾崚雅	固有一般
りょうが	崚雅	固有人名
いしかわあおい	石川蒼生	固有一般
あおい	蒼生	固有人名
いしかわあおと	石川碧人	固有一般
あおと	碧人	固有人名
いしかわけい	石川慧	固有一般
けい	慧	固有人名
いしかわけん	石川研	固有一般
けん	研	固有人名
いしかわけんたろう	石川健太郎	固有一般
いしかわげんだい	石川玄大	固有一般
げんだい	玄大	固有人名
いしかわこう	石川 康	固有一般
いしかわじょうじ	石川丈慈	固有一般
じょうじ	丈慈	固有人名
いしかわせいた	石川晴大	固有一般
せいた	晴大	固有人名
いしかわたかお	石川喬穂	固有一般
たかお	喬穂	固有人名
いしかわたつや	石川竜也	固有一般
たつや	竜也	固有人名
いしかわだいち	石川大地	固有一般
いしかわとしき	石川俊輝	固有一般
としき	俊輝	固有人名
いしかわなおき	石川直樹	固有一般
なおき	直樹	固有人名
いしかわなおと	石川直人	固有一般
いしかわなおひろ	石川直宏	固有一般
なおひろ	直宏	固有人名
いしかわなるき	石川成希	固有一般
なるき	成希	固有人名
いしかわひろき	石川大稀	固有一般
ひろき	大稀	固有人名
いしかわひろと	石川啓人	固有一般
ひろと	啓人	固有人名
いしかわひろのり	石川大徳	固有一般
ひろのり	大徳	固有人名
いしかわまさひろ	石川雅博	固有一般
いしかわゆうじ	石川裕司	固有一般
ゆうじ	裕司	固有人名
いしかわりゅうた	石川隆汰	固有一般
りゅうた	隆汰	固有人名
いしがきのりゆき	石垣徳之	固有一般
のりゆき	徳之	固有人名
いしがみこうせい	石神幸征	固有一般
こうせい	幸征	固有人名
いしかみしょうま	石上将馬	固有一般
しょうま	将馬	固有人名
いしがみなおや	石神直哉	固有一般
なおや	直哉	固有人名
いしがみわたる	石上航	固有一般
いしかめあきら	石亀晃	固有一般
あきら	晃	固有人名
いしがもりそうま	石ヶ森荘真	固有一般
そうま	荘真	固有人名
いしぐろともひさ	石黒智久	固有一般
ともひさ	智久	固有人名
いしげひでき	石毛秀樹	固有一般
ひでき	秀樹	固有人名
いしざかげんき	石坂元気	固有一般
げんき	元気	固有人名
いしざかりょうと	石坂亮人	固有一般
りょうと	亮人	固有人名
いしざきりょう	石崎諒	固有一般
りょう	諒	固有人名
いしざわのりあき	石澤典明	固有一般
のりあき	典明	固有人名
いしずえりゅうじ	石末龍治	固有一般
りゅうじ	龍治	固有人名
いしたにごいち	石谷吾一	固有一般
ごいち	吾一	固有人名
いしだこうた	石田皓大	固有一般
こうた	皓大	固有人名
いしだはやと	石田隼将	固有一般
はやと	隼将	固有人名
いしだひでゆき	石田英之	固有一般
ひでゆき	英之	固有人名
いしだひろゆき	石田博行	固有一般
ひろゆき	博行	固有人名
いしだまさと	石田雅人	固有一般
まさと	雅人	固有人名
いしだまさとし	石田雅俊	固有一般
いしだゆうき	石田祐樹	固有一般
ゆうき	祐樹	固有人名
いしだゆうすけ	石田侑資	固有一般
ゆうすけ	侑資	固有人名
いしだりょうたろう	石田凌太郎	固有一般
りょうたろう	凌太郎	固有人名
いしだりょうま	石田崚真	固有一般
りょうま	崚真	固有人名
いしだれいや	石田怜也	固有一般
れいや	怜也	固有人名
いしだてやすき	石舘靖樹	固有一般
やすき	靖樹	固有人名
いしづかい	石津快	固有一般
かい	快	固有人名
いしづだいすけ	石津大介	固有一般
いしづかけいじ	石塚啓次	固有一般
けいじ	啓次	固有人名
いしづかしん	石塚心	固有一般
しん	心	固有人名
いしどうかずと	石堂和人	固有一般
かずと	和人	固有人名
いしどうけいた	石堂圭太	固有一般
いしはらかつや	石原克哉	固有一般
かつや	克哉	固有人名
いしはらすかい	石原澄海	固有一般
すかい	澄海	固有人名
いしはらたかよし	石原崇兆	固有一般
たかよし	崇兆	固有人名
いしはらたく	石原卓	固有一般
たく	卓	固有人名
いしはらだいすけ	石原大助	固有一般
だいすけ	大助	固有人名
いしはらなおき	石原直樹	固有一般
いしはらひろかず	石原広教	固有一般
ひろかず	広教	固有人名
いしはらみらん	石原未蘭	固有一般
みらん	未蘭	固有人名
いしばしなおき	石橋直希	固有一般
いしばしふみや	石橋郁弥	固有一般
ふみや	郁弥	固有人名
いしびつようすけ	石櫃洋祐	固有一般
ようすけ	洋祐	固有人名
いしまたいせい	石間大誠	固有一般
たいせい	大誠	固有人名
いしまるきよたか	石丸清隆	固有一般
きよたか	清隆	固有人名
いしみねこうや	石嶺幸也	固有一般
こうや	幸也	固有人名
いしもりぜん	石森禅	固有一般
ぜん	禅	固有人名
いしやまあおぞら	石山青空	固有一般
あおぞら	青空	固有人名
いしわまさと	石輪聖人	固有一般
まさと	聖人	固有人名
いしわたあさひ	石渡旭	固有一般
あさひ	旭	固有人名
いしわたりねるそん	石渡ネルソン	固有一般
ねるそん	ネルソン	固有人名
いずましど	出間思努	固有一般
しど	思努	固有人名
いずみさいき	泉彩稀	固有一般
さいき	彩稀	固有人名
いずみそうたろう	泉宗太郎	固有一般
そうたろう	宗太郎	固有人名
いずみたかあき	泉孝明	固有一般
たかあき	孝明	固有人名
いずみとうや	泉柊椰	固有一般
とうや	柊椰	固有人名
いずみはやて	和泉颯	固有一般
はやて	颯	固有人名
いずみゆうや	泉悠哉	固有一般
ゆうや	悠哉	固有人名
いずみりゅうじ	和泉竜司	固有一般
りゅうじ	竜司	固有人名
いずみさわじん	泉澤仁	固有一般
いずもりりょうた	泉森涼太	固有一般
りょうた	涼太	固有人名
いせこう	伊勢航	固有一般
いせわたる	伊勢渉	固有一般
わたる	渉	固有人名
いそえたいせい	磯江太勢	固有一般
たいせい	太勢	固有人名
いそがいひろみつ	礒貝洋光	固有一般
ひろみつ	洋光	固有人名
いそがやかしん	磯ヶ谷佳心	固有一般
かしん	佳心	固有人名
いそざきけいた	磯崎敬太	固有一般
けいた	敬太	固有人名
いそざきまく	磯﨑麻玖	固有一般
まく	麻玖	固有人名
いそだよしかず	礒田由和	固有一般
よしかず	由和	固有人名
いそののぶひさ	磯野修久	固有一般
のぶひさ	修久	固有人名
いそべかんた	磯部勘太	固有一般
かんた	勘太	固有人名
いそむらりょうた	磯村亮太	固有一般
いそもといそもと	磯本蒼羽	固有一般
いそもと	蒼羽	固有人名
いそやまかずし	磯山和司	固有一般
かずし	和司	固有人名
いたきれん	板木蓮	固有一般
いたくらこう	板倉滉	固有一般
こう	滉	固有人名
いたくらたく	板倉洸	固有一般
たく	洸	固有人名
いたのよしたつ	板野圭竜	固有一般
よしたつ	圭竜	固有人名
いたはしようせい	板橋洋青	固有一般
ようせい	洋青	固有人名
いちはるき	市晴貴	固有一般
いちかわあきのり	市川暉記	固有一般
あきのり	暉記	固有人名
いちかわけいた	市川恵多	固有一般
けいた	恵多	固有人名
いちかわけんしろう	市川健志郎	固有一般
けんしろう	健志郎	固有人名
いちかわたいち	市河太一	固有一般
いちかわだいすけ	市川大祐	固有一般
だいすけ	大祐	固有人名
いちかわまさひこ	市川雅彦	固有一般
まさひこ	雅彦	固有人名
いちかわゆうま	市川侑麻	固有一般
ゆうま	侑麻	固有人名
いちきりゅういち	一木立一	固有一般
りゅういち	立一	固有人名
いちのいたかひと	一井賢人	固有一般
たかひと	賢人	固有人名
いちのせたいじゅ	一瀬大寿	固有一般
たいじゅ	大寿	固有人名
いちのせとうや	一瀬透也	固有一般
とうや	透也	固有人名
いちはらひろし	市原大嗣	固有一般
ひろし	大嗣	固有人名
いちはらみつき	市原充喜	固有一般
みつき	充喜	固有人名
いちはらりおん	市原吏音	固有一般
りおん	吏音	固有人名
いちはらりょうた	市原亮太	固有一般
いちまるみずき	市丸瑞希	固有一般
いちみかずなり	一美和成	固有一般
かずなり	和成	固有人名
いちみやけんた	一宮憲太	固有一般
けんた	憲太	固有人名
いちむらあつし	市村篤司	固有一般
あつし	篤司	固有人名
いちむらしんのすけ	市村慎之介	固有一般
しんのすけ	慎之介	固有人名
いちもりじゅん	一森純	固有一般
いちやなぎゆうご	一柳夢吾	固有一般
ゆうご	夢吾	固有人名
いづつりくや	井筒陸也	固有一般
りくや	陸也	固有人名
いでけい	井手圭	固有一般
いでけいた	井出敬大	固有一般
けいた	敬大	固有人名
いではるや	井出遥也	固有一般
はるや	遥也	固有人名
いでまなと	井手真渚人	固有一般
まなと	真渚人	固有人名
いでぐちじゅん	井手口純	固有一般
いでぐちまさあき	井手口正昭	固有一般
まさあき	正昭	固有人名
いでぐちようすけ	井手口陽介	固有一般
いといみさき	糸井岬	固有一般
みさき	岬	固有人名
いとうあきら	伊藤彰	固有一般
あきら	彰	固有人名
いとうあつき	伊藤敦樹	固有一般
あつき	敦樹	固有人名
いとうあつし	伊藤淳嗣	固有一般
あつし	淳嗣	固有人名
いとうかずき	伊藤和基	固有一般
かずき	和基	固有人名
いとうけい	伊藤慧	固有一般
いとうけいすけ	伊藤恵亮	固有一般
けいすけ	恵亮	固有人名
いとうけんじ	伊藤健次	固有一般
けんじ	健次	固有人名
いとうけんた	伊藤研太	固有一般
けんた	研太	固有人名
いとうげんた	伊藤元太	固有一般
げんた	元太	固有人名
いとうこうき	伊東倖希	固有一般
こうき	倖希	固有人名
いとうこうき	伊藤晃希	固有一般
こうき	晃希	固有人名
いとうこうた	伊藤康太	固有一般
こうた	康太	固有人名
いとうこじろう	伊藤小次郎	固有一般
こじろう	小次郎	固有人名
いとうごう	伊藤剛	固有一般
ごう	剛	固有人名
いとうしのぶ	伊藤仁	固有一般
しのぶ	仁	固有人名
いとうしゅん	伊東俊	固有一般
しゅん	俊	固有人名
いとうしょう	伊藤翔	固有一般
いとうしんご	伊東真吾	固有一般
いとうしんのすけ	伊東進之輔	固有一般
しんのすけ	進之輔	固有人名
いとうじゅんや	伊藤純也	固有一般
じゅんや	純也	固有人名
いとうじゅんや	伊東純也	固有一般
いとうすぐる	伊藤卓	固有一般
すぐる	卓	固有人名
いとうそうま	伊藤颯真	固有一般
そうま	颯真	固有人名
いとうたいよう	伊藤太陽	固有一般
いとうたかみつ	伊藤駿光	固有一般
たかみつ	駿光	固有人名
いとうたくま	伊藤拓真	固有一般
いとうたくみ	伊藤拓巳	固有一般
たくみ	拓巳	固有人名
いとうたくや	伊藤琢矢	固有一般
たくや	琢矢	固有人名
いとうたくや	伊藤卓弥	固有一般
たくや	卓弥	固有人名
いとうだいすけ	伊藤大介	固有一般
いとうだん	伊藤壇	固有一般
だん	壇	固有人名
いとうてつや	伊藤哲也	固有一般
いとうてるよし	伊東輝悦	固有一般
てるよし	輝悦	固有人名
いとうともひこ	伊藤友彦	固有一般
いとうひろき	伊藤宏樹	固有一般
ひろき	宏樹	固有人名
いとうひろき	伊藤洋輝	固有一般
ひろき	洋輝	固有人名
いとうまきと	伊藤槙人	固有一般
まきと	槙人	固有人名
いとうゆうじ	伊藤裕二	固有一般
ゆうじ	裕二	固有人名
いとうゆうせい	伊藤優世	固有一般
ゆうせい	優世	固有人名
いとうゆうた	伊藤優汰	固有一般
ゆうた	優汰	固有人名
いとうゆうた	伊藤友太	固有一般
ゆうた	友太	固有人名
いとうゆきとし	伊東幸敏	固有一般
ゆきとし	幸敏	固有人名
いとうゆたか	伊藤雄教	固有一般
ゆたか	雄教	固有人名
いとうゆづき	伊藤優津樹	固有一般
ゆづき	優津樹	固有人名
いとうりゅうじ	伊藤竜司	固有一般
いとうりゅうすけ	伊藤隆介	固有一般
りゅうすけ	隆介	固有人名
いとうりゅうせい	伊藤龍生	固有一般
りゅうせい	龍生	固有人名
いとうりゅうと	伊藤隆人	固有一般
りゅうと	隆人	固有人名
いとうりょうすけ	伊藤稜介	固有一般
りょうすけ	稜介	固有人名
いとうりょうせい	伊東稜晟	固有一般
りょうせい	稜晟	固有人名
いとうりょうたろう	伊藤涼太郎	固有一般
りょうたろう	涼太郎	固有人名
いとうりょうま	伊藤稜馬	固有一般
りょうま	稜馬	固有人名
いとうりょうや	伊藤遼哉	固有一般
りょうや	遼哉	固有人名
いとうるい	伊藤琉偉	固有一般
いとがつばさ	糸賀大翼	固有一般
つばさ	大翼	固有人名
いとはらこうしろう	糸原紘史郎	固有一般
こうしろう	紘史郎	固有人名
いとやまじん	糸山仁	固有一般
いながきあつし	稲垣 篤志	固有一般
あつし	篤志	固有人名
いながきしょう	稲垣祥	固有一般
しょう	祥	固有人名
いながきひろゆき	稲垣博行	固有一般
いながきゆうた	稲垣雄太	固有一般
ゆうた	雄太	固有人名
いながわあおき	稲川碧希	固有一般
あおき	碧希	固有人名
いながわはる	稲川暖大	固有一般
はる	暖大	固有人名
いなだこうじ	稲田康志	固有一般
こうじ	康志	固有人名
いなずみだいすけ	稲積大介	固有一般
いなばあがし	稲葉亜我志	固有一般
あがし	亜我志	固有人名
いなばがく	稲葉楽	固有一般
がく	楽	固有人名
いなばしゅうと	稲葉修土	固有一般
しゅうと	修土	固有人名
いなばひさひと	稲葉久人	固有一般
ひさひと	久人	固有人名
いなふくたく	稲福卓	固有一般
いなみじゅん	伊波純	固有一般
いなみせな	井波靖奈	固有一般
せな	靖奈	固有人名
いなみてつゆき	稲見哲行	固有一般
てつゆき	哲行	固有人名
いなむらはやと	稲村隼翔	固有一般
はやと	隼翔	固有人名
いなもとじゅんいち	稲本潤一	固有一般
じゅんいち	潤一	固有人名
いなもりかつなお	稲森克尚	固有一般
かつなお	克尚	固有人名
いぬいたかし	乾貴士	固有一般
たかし	貴士	固有人名
いぬいたかや	乾貴哉	固有一般
たかや	貴哉	固有人名
いぬいたつろう	乾達朗	固有一般
たつろう	達朗	固有人名
いぬいだいち	乾大知	固有一般
だいち	大知	固有人名
いぬかいともや	犬飼智也	固有一般
ともや	智也	固有人名
いぬかいゆうや	犬飼裕哉	固有一般
ゆうや	裕哉	固有人名
いぬづかゆうすけ	犬塚友輔	固有一般
ゆうすけ	友輔	固有人名
いのぶんた	井野文太	固有一般
ぶんた	文太	固有人名
いのうえあつし	井上敦史	固有一般
あつし	敦史	固有人名
いのうえかずま	井上和馬	固有一般
かずま	和馬	固有人名
いのうえかんた	井上寛太	固有一般
かんた	寛太	固有人名
いのうえけんた	井上健太	固有一般
いのうえこう	井上巧	固有一般
こう	巧	固有人名
いのうえこうき	井上航希	固有一般
こうき	航希	固有人名
いのうえこうへい	井上公平	固有一般
こうへい	公平	固有人名
いのうえしおん	井上潮音	固有一般
しおん	潮音	固有人名
いのうえしおん	井上詩音	固有一般
しおん	詩音	固有人名
いのうえしょうた	井上翔太	固有一般
いのうえしょうた	井上湘太	固有一般
しょうた	湘太	固有人名
いのうえじょう	井上丈	固有一般
じょう	丈	固有人名
いのうえせいや	井上征哉	固有一般
せいや	征哉	固有人名
いのうえせいや	井上聖也	固有一般
せいや	聖也	固有人名
いのうえたいら	井上平	固有一般
たいら	平	固有人名
いのうえとき	井上斗希	固有一般
とき	斗希	固有人名
いのうえなおき	井上直輝	固有一般
なおき	直輝	固有人名
いのうえひかる	井上輝	固有一般
いのうえひでと	井上秀人	固有一般
ひでと	秀人	固有人名
いのうえみき	井上樹	固有一般
みき	樹	固有人名
いのうえめぐむ	井上恵武	固有一般
めぐむ	恵武	固有人名
いのうえもとなり	井上源就	固有一般
もとなり	源就	固有人名
いのうえゆうき	井上雄幾	固有一般
ゆうき	雄幾	固有人名
いのうえゆうだい	井上裕大	固有一般
ゆうだい	裕大	固有人名
いのうえゆうと	井上雄斗	固有一般
ゆうと	雄斗	固有人名
いのうえりきと	井上黎生人	固有一般
りきと	黎生人	固有人名
いのうえりょうが	井上亮雅	固有一般
りょうが	亮雅	固有人名
いのうえりょうた	井上竜太	固有一般
りょうた	竜太	固有人名
いのうえりょうた	井上亮太	固有一般
いのうえりょうたろう	井上椋太郎	固有一般
りょうたろう	椋太郎	固有人名
いのうえれん	井上怜	固有一般
れん	怜	固有人名
いのうえわたる	井上渉	固有一般
いのおたくみ	井ノ尾匠	固有一般
たくみ	匠	固有人名
いのこしゆい	猪越優惟	固有一般
ゆい	優惟	固有人名
いのせこうすけ	猪瀬康介	固有一般
こうすけ	康介	固有人名
いのはまさひこ	伊野波雅彦	固有一般
いのりりょうま	禱涼真	固有一般
りょうま	涼真	固有人名
いはたしょうたろう	井畑翔太郎	固有一般
しょうたろう	翔太郎	固有人名
いはらしんたろう	井原伸太郎	固有一般
しんたろう	伸太郎	固有人名
いはらまさみ	井原正巳	固有一般
まさみ	正巳	固有人名
いはらやすひで	井原康秀	固有一般
やすひで	康秀	固有人名
いばこうたろう	射庭康太朗	固有一般
こうたろう	康太朗	固有人名
いばたひろやす	井幡博康	固有一般
ひろやす	博康	固有人名
いばやしあきら	井林章	固有一般
あきら	章	固有人名
いびしゅんと	揖斐俊斗	固有一般
しゅんと	俊斗	固有人名
いぶすきひろし	指宿洋史	固有一般
ひろし	洋史	固有人名
いほりかずあき	井堀二昭	固有一般
かずあき	二昭	固有人名
いまいかんた	今井勘太	固有一般
いまいけいた	今井啓太	固有一般
けいた	啓太	固有人名
いまいしょうた	今井昌太	固有一般
しょうた	昌太	固有人名
いまいだいご	今井大悟	固有一般
いまいともき	今井智基	固有一般
ともき	智基	固有人名
いまいはやと	今井颯人	固有一般
はやと	颯人	固有人名
いまかけこうき	今掛航貴	固有一般
こうき	航貴	固有人名
いまかねゆめと	今金夢斗	固有一般
ゆめと	夢斗	固有人名
いまがわまさき	今川正樹	固有一般
まさき	正樹	固有人名
いまがわもとき	今川元樹	固有一般
もとき	元樹	固有人名
いまくらひでゆき	今倉秀之	固有一般
ひでゆき	秀之	固有人名
いませじゅんや	今瀬淳也	固有一般
じゅんや	淳也	固有人名
いまぜきこうへい	今関耕平	固有一般
いまづゆうた	今津佑太	固有一般
ゆうた	佑太	固有人名
いまふくけんのり	今福剣之典	固有一般
けんのり	剣之典	固有人名
いむらゆうき	今村優貴	固有一般
ゆうき	優貴	固有人名
いむらゆうすけ	今村優介	固有一般
ゆうすけ	優介	固有人名
いむらゆうすけ	今村勇介	固有一般
ゆうすけ	勇介	固有人名
いむらりくと	今村陸人	固有一般
りくと	陸人	固有人名
いむらりょういち	今村涼一	固有一般
りょういち	涼一	固有人名
いまよしこうへい	今吉晃平	固有一般
こうへい	晃平	固有人名
りんどんひゅん	林東賢	固有一般
どんひゅん	東賢	固有人名
りんようかん	林裕煥	固有一般
ようかん	裕煥	固有人名
いもとたかし	井本喬士	固有一般
たかし	喬士	固有人名
いよはおさむへんりー	イヨハ理ヘンリー	固有一般
いよりけいたろう	伊従啓太郎	固有一般
けいたろう	啓太郎	固有人名
いりいかずひさ	入井和久	固有一般
かずひさ	和久	固有人名
いりえしょうた	入江将太	固有一般
しょうた	将太	固有人名
いりえとおる	入江徹	固有一般
いりえとしかず	入江利和	固有一般
としかず	利和	固有人名
いりえゆうじん	入江優仁	固有一般
ゆうじん	優仁	固有人名
いりふねかずま	入船和真	固有一般
かずま	和真	固有人名
いるまがわけいた	入間川景太	固有一般
けいた	景太	固有人名
いわいあつひろ	岩井厚裕	固有一般
あつひろ	厚裕	固有人名
いわいしゅうや	岩井柊弥	固有一般
しゅうや	柊弥	固有人名
いわいりょうま	磐井稜真	固有一般
りょうま	稜真	固有人名
いわおけん	岩尾憲	固有一般
けん	憲	固有人名
いわかべひろや	岩壁裕也	固有一般
ひろや	裕也	固有人名
いわかみゆうぞう	岩上祐三	固有一般
ゆうぞう	祐三	固有人名
いわかわはるひこ	岩川晴彦	固有一般
はるひこ	晴彦	固有人名
いわきだいすけ	岩城大助	固有一般
いわぎしそうし	岩岸宗志	固有一般
そうし	宗志	固有人名
いわくらかずや	岩倉一弥	固有一般
かずや	一弥	固有人名
いわさきかずさ	岩﨑 知瑳	固有一般
いわさきけいご	岩崎圭吾	固有一般
けいご	圭吾	固有人名
いわさきゆうと	岩崎悠人	固有一般
ゆうと	悠人	固有人名
いわさきようへい	岩﨑陽平	固有一般
ようへい	陽平	固有人名
いわさきりょうま	岩崎涼馬	固有一般
いわさわきりと	岩澤桐人	固有一般
きりと	桐人	固有人名
いわさわとおる	岩澤徹	固有一般
いわざきかいが	岩﨑海駕	固有一般
かいが	海駕	固有人名
いわさきやすゆき	岩崎泰之	固有一般
やすゆき	泰之	固有人名
いわしたけいすけ	岩下敬輔	固有一般
けいすけ	敬輔	固有人名
いわしたじゅん	岩下潤	固有一般
いわしたわたる	岩下航	固有一般
いわせけん	岩瀬健	固有一般
けん	健	固有人名
いわせごう	磐瀬剛	固有一般
いわたこうき	岩田康貴	固有一般
こうき	康貴	固有人名
いわたしょうた	岩田正太	固有一般
しょうた	正太	固有人名
いわたたくや	岩田拓也	固有一般
いわたともき	岩田智輝	固有一般
ともき	智輝	固有人名
いわたまさひろ	岩田昌浩	固有一般
まさひろ	昌浩	固有人名
いわたけかつや	岩武克弥	固有一般
かつや	克弥	固有人名
いわだてなお	岩舘直	固有一般
なお	直	固有人名
いわだてゆうや	岩舘侑哉	固有一般
ゆうや	侑哉	固有人名
いわながそうた	岩永創太	固有一般
そうた	創太	固有人名
いわなみたくや	岩波拓也	固有一般
いわぬましゅんすけ	岩沼俊介	固有一般
しゅんすけ	俊介	固有人名
いわねりゅうた	岩根隆大	固有一般
りゅうた	隆大	固有人名
いわぶちひろと	岩渕弘人	固有一般
ひろと	弘人	固有人名
いわぶちりょうた	岩渕良太	固有一般
いわまけいた	岩間慶太	固有一般
けいた	慶太	固有人名
いわまゆうだい	岩間雄大	固有一般
ゆうだい	雄大	固有人名
いわまさだいき	岩政大樹	固有一般
いわまるふみや	岩丸史也	固有一般
ふみや	史也	固有人名
いわもとあいと	岩元愛翔	固有一般
あいと	愛翔	固有人名
いわもとかずき	岩本和希	固有一般
かずき	和希	固有人名
いわもとしょう	岩本翔	固有一般
いわもとしょうご	岩本昇悟	固有一般
しょうご	昇悟	固有人名
いわもとてるお	岩本輝雄	固有一般
てるお	輝雄	固有人名
いわもとともゆき	岩本知幸	固有一般
ともゆき	知幸	固有人名
いわもとひろなり	岩元洋成	固有一般
ひろなり	洋成	固有人名
いわもとゆうだい	岩本侑大	固有一般
ゆうだい	侑大	固有人名
いわもとゆうや	岩本悠也	固有一般
ゆうや	悠也	固有人名
いわもとりゅうおりびえ	岩元颯オリビエ	固有一般
りゅうおりびえ	颯オリビエ	固有人名
いわもとりょう	岩本陵	固有一般
りょう	陵	固有人名
いわもとるな	岩元ルナ	固有一般
るな	ルナ	固有人名
うさんほ	禹相皓	固有一般
さんほ	相皓	固有人名
うしょうそ	呉少聰	固有一般
しょうそ	少聰	固有人名
うえびすかつのり	上夷克典	固有一般
かつのり	克典	固有人名
うえおかりく	上岡陸	固有一般
うえくさゆうき	植草裕樹	固有一般
ゆうき	裕樹	固有人名
うえさとかずま	上里一将	固有一般
かずま	一将	固有人名
うえさとたくみ	上里琢文	固有一般
たくみ	琢文	固有人名
うえじょさとき	上門知樹	固有一般
さとき	知樹	固有人名
うえたけゆうた	植竹優太	固有一般
ゆうた	優太	固有人名
うえだあやせ	上田綺世	固有一般
あやせ	綺世	固有人名
うえだいつき	上田樹	固有一般
いつき	樹	固有人名
うえだきょうへい	上田恭平	固有一般
きょうへい	恭平	固有人名
うえだけいすけ	植田圭祐	固有一般
けいすけ	圭祐	固有人名
うえだけいた	植田啓太	固有一般
うえだけんと	上田健斗	固有一般
うえだこうた	上田康太	固有一般
うえだこうへい	上田航平	固有一般
こうへい	航平	固有人名
うえだしゅんすけ	植田峻佑	固有一般
しゅんすけ	峻佑	固有人名
うえだともき	上田智輝	固有一般
うえだなおみち	植田直通	固有一般
なおみち	直通	固有人名
うえだはやと	上田駿斗	固有一般
はやと	駿斗	固有人名
うえだゆうき	上田侑輝	固有一般
ゆうき	侑輝	固有人名
うえだゆうき	上田悠起	固有一般
ゆうき	悠起	固有人名
うえだゆうた	植田悠太	固有一般
うえだりゅうじろう	植田龍仁朗	固有一般
りゅうじろう	龍仁朗	固有人名
うえだりゅうほ	上田龍朋	固有一般
りゅうほ	龍朋	固有人名
うえだりょうや	上田陵弥	固有一般
りょうや	陵弥	固有人名
うえなかあさひ	植中朝日	固有一般
あさひ	朝日	固有人名
うえにしはるき	上西遥喜	固有一般
はるき	遥喜	固有人名
うえのあきと	上野輝人	固有一般
あきと	輝人	固有人名
うえのえいた	上野瑛太	固有一般
えいた	瑛太	固有人名
うえのけんと	上野賢人	固有一般
けんと	賢人	固有人名
うえのそうた	上野綜太	固有一般
そうた	綜太	固有人名
うえののぶひろ	上野展裕	固有一般
のぶひろ	展裕	固有人名
うえのひであき	上野秀章	固有一般
ひであき	秀章	固有人名
うえのゆうさく	上野優作	固有一般
ゆうさく	優作	固有人名
うえのよしはる	上野良治	固有一般
よしはる	良治	固有人名
うえのりゅうのすけ	上野隆之介	固有一般
りゅうのすけ	隆之介	固有人名
うえのやまかなた	上野山叶夢	固有一般
かなた	叶夢	固有人名
うえはたうへいじ	上畑佑平士	固有一般
うへいじ	佑平士	固有人名
うえはらえどうぃん	上原 エドウィン	固有一般
うえはらしんや	上原慎也	固有一般
しんや	慎也	固有人名
うえはらたくろう	上原拓郎	固有一般
たくろう	拓郎	固有人名
うえはらまきと	上原牧人	固有一般
まきと	牧人	固有人名
うえはらりきや	上原力也	固有一般
りきや	力也	固有人名
うえまつよう	上松瑛	固有一般
よう	瑛	固有人名
うえむらえいいち	植村映一	固有一般
えいいち	映一	固有人名
うえむらけい	植村慶	固有一般
けい	慶	固有人名
うえむらけんいち	上村健一	固有一般
けんいち	健一	固有人名
うえむらしゅういち	植村修一	固有一般
しゅういち	修一	固有人名
うえむらすすむ	植村晋	固有一般
すすむ	晋	固有人名
うえむらたかし	上村崇士	固有一般
うえむらともや	植村友哉	固有一般
ともや	友哉	固有人名
うえむらひろと	植村洋斗	固有一般
ひろと	洋斗	固有人名
うえむらみさき	上村岬	固有一般
うえもとぎんた	上本銀太	固有一般
ぎんた	銀太	固有人名
うえもとたいかい	上本大海	固有一般
たいかい	大海	固有人名
うえもとだいき	植本大貴	固有一般
だいき	大貴	固有人名
うおざとなおや	魚里直哉	固有一般
うかいりょうた	鵜飼亮多	固有一般
りょうた	亮多	固有人名
うがじんともや	宇賀神友弥	固有一般
ともや	友弥	固有人名
うきてつろう	浮氣哲郎	固有一般
てつろう	哲郎	固有人名
うきたけんせい	浮田健誠	固有一般
けんせい	健誠	固有人名
うさがわまお	宇佐川眞央	固有一般
まお	眞央	固有人名
うさみたかし	宇佐美貴史	固有一般
うさみひろかず	宇佐美宏和	固有一般
ひろかず	宏和	固有人名
うしこしたいが	牛越大河	固有一般
たいが	大河	固有人名
うしざわけん	牛澤健	固有一般
うしのはまたく	牛之濵拓	固有一般
うしばなけん	牛鼻健	固有一般
うじいえたかし	氏家貴士	固有一般
うじいえひでゆき	氏家英行	固有一般
ひでゆき	英行	固有人名
うじはらりょうじ	氏原良二	固有一般
りょうじ	良二	固有人名
うすいかんた	臼井貫太	固有一般
うすいけんぺい	碓井健平	固有一般
けんぺい	健平	固有人名
うすいこうへい	臼井幸平	固有一般
こうへい	幸平	固有人名
うすいしょうせい	碓井聖生	固有一般
しょうせい	聖生	固有人名
うすみせいりょう	宇水聖凌	固有一般
せいりょう	聖凌	固有人名
うすいてっぺい	碓井鉄平	固有一般
うすいはると	臼井春翔	固有一般
はると	春翔	固有人名
うすいはると	薄井覇斗	固有一般
はると	覇斗	固有人名
うすいひとし	臼井仁志	固有一般
ひとし	仁志	固有人名
うすばはやと	薄葉迅人	固有一般
はやと	迅人	固有人名
うたかかいと	宇高魁人	固有一般
かいと	魁人	固有人名
うだこうしろう	宇田光史朗	固有一般
こうしろう	光史朗	固有人名
うちがしまたくみ	内賀嶋巧	固有一般
うちこしたいき	打越大樹	固有一般
たいき	大樹	固有人名
うちぞのひろたか	内薗大貴	固有一般
ひろたか	大貴	固有人名
うちだあつと	内田篤人	固有一般
あつと	篤人	固有人名
うちだかずし	内田和志	固有一般
かずし	和志	固有人名
うちだきょうへい	内田恭兵	固有一般
きょうへい	恭兵	固有人名
うちだけんた	内田健太	固有一般
うちだこうすけ	内田昂輔	固有一般
こうすけ	昂輔	固有人名
うちだこうすけ	内田康介	固有一般
うちだこうへい	内田航平	固有一般
うちだしゅうと	内田修人	固有一般
しゅうと	修人	固有人名
うちだじゅん	内田潤	固有一般
うちだたくや	内田宅哉	固有一般
たくや	宅哉	固有人名
うちだたつや	内田達也	固有一般
うちだだいき	内田大貴	固有一般
うちだてっぺい	内田哲兵	固有一般
てっぺい	哲兵	固有人名
うちだとしひろ	内田利広	固有一般
としひろ	利広	固有人名
うちだともや	内田智也	固有一般
うちだみずき	内田瑞己	固有一般
みずき	瑞己	固有人名
うちだゆうせい	内田優晟	固有一般
ゆうせい	優晟	固有人名
うちだゆうと	内田裕斗	固有一般
ゆうと	裕斗	固有人名
うちだれんぺい	内田錬平	固有一般
れんぺい	錬平	固有人名
うちだてひでき	内舘秀樹	固有一般
うちのこうたろう	内野航太郎	固有一般
こうたろう	航太郎	固有人名
うちのたかし	内野貴志	固有一般
うちばやしひろたか	内林広高	固有一般
ひろたか	広高	固有人名
うちぼりたいき	内堀太貴	固有一般
たいき	太貴	固有人名
うちまやすみち	内間安路	固有一般
やすみち	安路	固有人名
うちむらよしひろ	内村圭宏	固有一般
よしひろ	圭宏	固有人名
うちむらりんたろう	内村凜太朗	固有一般
りんたろう	凜太朗	固有人名
うちやまけい	内山圭	固有一般
うちやまこうき	内山航紀	固有一般
こうき	航紀	固有人名
うちやましょうた	内山翔太	固有一般
うちやまじゅん	内山純	固有一般
うちやまたくみ	内山拓海	固有一般
うちやまとしひこ	内山俊彦	固有一般
としひこ	俊彦	固有人名
うちやまゆうき	内山裕貴	固有一般
ゆうき	裕貴	固有人名
うつみあおと	内海碧斗	固有一般
あおと	碧斗	固有人名
うつみしゅうき	内海柊輝	固有一般
しゅうき	柊輝	固有人名
うつみはるき	内海陽樹	固有一般
はるき	陽樹	固有人名
うつもとしんや	宇津元伸弥	固有一般
しんや	伸弥	固有人名
うどうむう	有働夢叶	固有一般
むう	夢叶	固有人名
うねおけんしん	畝尾拳槙	固有一般
けんしん	拳槙	固有人名
うのぜんと	宇野禅斗	固有一般
ぜんと	禅斗	固有人名
うのきふみや	鵜木郁哉	固有一般
ふみや	郁哉	固有人名
うのざわゆうじ	宇野沢祐次	固有一般
ゆうじ	祐次	固有人名
うまこしひかる	馬越晃	固有一般
ひかる	晃	固有人名
うめいだいき	梅井大輝	固有一般
だいき	大輝	固有人名
うめきけんと	梅木絢都	固有一般
けんと	絢都	固有人名
うめきつばさ	梅木翼	固有一般
うめきれい	梅木怜	固有一般
うめさきつかさ	梅崎司	固有一般
つかさ	司	固有人名
うめざわたかし	梅澤貴史	固有一般
うめざわまなぶ	梅澤学	固有一般
うめだかいと	梅田凱斗	固有一般
かいと	凱斗	固有人名
うめだかいと	梅田魁人	固有一般
うめだたかし	梅田高志	固有一般
たかし	高志	固有人名
うめだとうご	梅田透吾	固有一般
とうご	透吾	固有人名
うめだなおや	梅田直哉	固有一般
うめだりく	梅田陸空	固有一般
りく	陸空	固有人名
うめつだにえる	梅津ダニエル	固有一般
だにえる	ダニエル	固有人名
うめつれお	梅津怜央	固有一般
れお	怜央	固有人名
うめずかつき	梅津克貴	固有一般
かつき	克貴	固有人名
うめないかずま	梅内和磨	固有一般
かずま	和磨	固有人名
うめはらかける	梅原翔琉	固有一般
かける	翔琉	固有人名
うめばちたかひで	梅鉢貴秀	固有一般
たかひで	貴秀	固有人名
うめむらはるき	梅村晴貴	固有一般
うめやまおさむ	梅山修	固有一般
おさむ	修	固有人名
うらじゅうぞう	浦十藏	固有一般
じゅうぞう	十藏	固有人名
うらひろし	浦紘史	固有一般
ひろし	紘史	固有人名
うらかみたけし	浦上壮史	固有一般
たけし	壮史	固有人名
うらかみにき	浦上仁騎	固有一般
にき	仁騎	固有人名
うらかわともき	浦川友希	固有一般
ともき	友希	固有人名
うらしまたかひろ	浦島貴大	固有一般
たかひろ	貴大	固有人名
うらたいつき	浦田樹	固有一般
うらたなおき	浦田尚希	固有一般
なおき	尚希	固有人名
うらたのぶひさ	浦田延尚	固有一般
のぶひさ	延尚	固有人名
うらべたろう	卜部太郎	固有一般
たろう	太郎	固有人名
うらべてんじゅ	占部天寿	固有一般
てんじゅ	天寿	固有人名
うらもとけんたろう	浦本賢太郎	固有一般
けんたろう	賢太郎	固有人名
うりゅうこせい	瓜生昂勢	固有一般
こせい	昂勢	固有人名
うるしだてけんた	漆舘拳大	固有一般
けんた	拳大	固有人名
うるのじゅん	宇留野純	固有一般
たかぎけいん	高木 ケイン	固有一般
えいながたかとら	永長鷹虎	固有一般
たかとら	鷹虎	固有人名
えがしらかずき	江頭一輝	固有一般
かずき	一輝	固有人名
えがみりゅうた	江上竜汰	固有一般
りゅうた	竜汰	固有人名
えがわげんき	江川慶城	固有一般
げんき	慶城	固有人名
えがわしげみつ	江川重光	固有一般
しげみつ	重光	固有人名
えがわゆうせい	江川湧清	固有一般
ゆうせい	湧清	固有人名
えぐちたくま	江口拓真	固有一般
えぐちともじ	江口倫司	固有一般
ともじ	倫司	固有人名
えぐちなお	江口直生	固有一般
なお	直生	固有人名
えぐちりょうま	江口稜馬	固有一般
えごけんいち	江後賢一	固有一般
けんいち	賢一	固有人名
えさかあたる	江坂任	固有一般
あたる	任	固有人名
えさきかずひと	江﨑一仁	固有一般
かずひと	一仁	固有人名
えざきたくろう	江﨑巧朗	固有一般
たくろう	巧朗	固有人名
えじりあつひこ	江尻篤彦	固有一般
あつひこ	篤彦	固有人名
えすくでろせるひお	エスクデロ 競飛王	固有一般
えすみけんた	江角健太	固有一般
えずみこうじ	江角浩司	固有一般
こうじ	浩司	固有人名
えぞえけんじろう	江添建次郎	固有一般
けんじろう	建次郎	固有人名
えだひろし	江田広	固有一般
ひろし	広	固有人名
えだむらたくま	枝村匠馬	固有一般
たくま	匠馬	固有人名
えだもとゆういちろう	枝本雄一郎	固有一般
ゆういちろう	雄一郎	固有人名
えちごかずお	越後和男	固有一般
かずお	和男	固有人名
えとうまさし	江藤将司	固有一般
まさし	将司	固有人名
えとうみきや	衛藤幹弥	固有一般
みきや	幹弥	固有人名
えとうゆう	衛藤裕	固有一般
ゆう	裕	固有人名
えのもといつき	榎本樹	固有一般
えのもとけいご	榎本啓吾	固有一般
けいご	啓吾	固有人名
えのもとこうだい	榎本滉大	固有一般
こうだい	滉大	固有人名
えのもとじゅん	榎本潤	固有一般
えのもとたつや	榎本達也	固有一般
えのもとだいき	榎本大輝	固有一般
えのもとてつや	榎本哲也	固有一般
えはらえいじ	江原叡志	固有一般
えいじ	叡志	固有人名
えばしゆうと	江橋勇斗	固有一般
ゆうと	勇斗	固有人名
えばたしゅんすけ	江幡俊介	固有一般
えるしゃたーぶぶらいとかい	エルシャターブブライト海	固有一般
ぶらいとかい	ブライト海	固有人名
えんどうあきひろ	遠藤彰弘	固有一般
あきひろ	彰弘	固有人名
えんどうけいすけ	遠藤敬佑	固有一般
けいすけ	敬佑	固有人名
えんどうけいた	遠藤渓太	固有一般
けいた	渓太	固有人名
えんどうげんいち	遠藤元一	固有一般
げんいち	元一	固有人名
えんどうさいた	遠藤才大	固有一般
さいた	才大	固有人名
えんどうじゅんき	遠藤純輝	固有一般
じゅんき	純輝	固有人名
えんどうたいし	遠藤大志	固有一般
たいし	大志	固有人名
えんどうたかひろ	遠藤孝弘	固有一般
たかひろ	孝弘	固有人名
えんどうひかる	遠藤光	固有一般
えんどうまさき	遠藤雅己	固有一般
まさき	雅己	固有人名
えんどうまさひろ	遠藤昌浩	固有一般
えんどうまさよし	圓道将良	固有一般
まさよし	将良	固有人名
えんどうやすし	遠藤康	固有一般
やすし	康	固有人名
えんどうやすひと	遠藤保仁	固有一般
やすひと	保仁	固有人名
えんどうりょう	遠藤凌	固有一般
りょう	凌	固有人名
えんどうわたる	遠藤航	固有一般
おじゃんえん	呉章銀	固有一般
じゃんえん	章銀	固有人名
おいじけいた	生地慶多	固有一般
けいた	慶多	固有人名
おいじたいよう	生地太陽	固有一般
おいじよしあつ	生地慶充	固有一般
よしあつ	慶充	固有人名
おいずみだいき	尾泉大樹	固有一般
おいでふみや	大出文哉	固有一般
ふみや	文哉	固有人名
わんしんう	王新宇	固有一般
しんう	新宇	固有人名
おうぎはらたかひろ	扇原貴宏	固有一般
たかひろ	貴宏	固有人名
おだまこと	網田慎	固有一般
まこと	慎	固有人名
おおいけんたろう	大井健太郎	固有一般
おおいしあすき	大石明日希	固有一般
あすき	明日希	固有人名
おおいしあつと	大石篤人	固有一般
おおいしけんた	大石健太	固有一般
おおいしさとし	大石悟司	固有一般
さとし	悟司	固有人名
おおいしたかお	大石隆夫	固有一般
たかお	隆夫	固有人名
おおいしたかや	大石尚哉	固有一般
たかや	尚哉	固有人名
おおいしだん	大石暖	固有一般
だん	暖	固有人名
おおいしつぐとし	大石治寿	固有一般
つぐとし	治寿	固有人名
おおいしてつや	大石鉄也	固有一般
てつや	鉄也	固有人名
おおいしのぶゆき	大石信幸	固有一般
のぶゆき	信幸	固有人名
おおいしふみや	大石文弥	固有一般
ふみや	文弥	固有人名
おおいしゆうすけ	大石悠介	固有一般
ゆうすけ	悠介	固有人名
おおいしりゅうへい	大石竜平	固有一般
りゅうへい	竜平	固有人名
おおいしりょう	大石玲	固有一般
りょう	玲	固有人名
おおいずみかずや	大泉和也	固有一般
おおいわかずき	大岩一貴	固有一般
おおいわごう	大岩剛	固有一般
おおいわてっぺい	大岩徹平	固有一般
てっぺい	徹平	固有人名
おおいわりょうた	大岩亮太	固有一般
おおうちいっせい	大内一生	固有一般
いっせい	一生	固有人名
おおえゆうじ	大江勇詞	固有一般
ゆうじ	勇詞	固有人名
おおえのきかつみ	大榎克己	固有一般
かつみ	克己	固有人名
おおかわけい	大川圭為	固有一般
けい	圭為	固有人名
おおがきゆうき	大垣勇樹	固有一般
おおがみともあき	大神友明	固有一般
ともあき	友明	固有人名
おがわらゆうと	大河原優斗	固有一般
ゆうと	優斗	固有人名
おおきさとる	大木暁	固有一般
さとる	暁	固有人名
おおきすすむ	大木勉	固有一般
すすむ	勉	固有人名
おおくぼごうし	大久保剛志	固有一般
ごうし	剛志	固有人名
おおくぼたかひろ	大久保貴広	固有一般
たかひろ	貴広	固有人名
おおくぼたくお	大久保択生	固有一般
たくお	択生	固有人名
おおくぼたつと	大久保龍人	固有一般
たつと	龍人	固有人名
おおくぼてつや	大久保哲哉	固有一般
てつや	哲哉	固有人名
おおくぼともあき	大久保智明	固有一般
ともあき	智明	固有人名
おおくぼまこと	大久保誠	固有一般
おおくぼゆう	大久保優	固有一般
おおくぼゆうき	大久保祐希	固有一般
ゆうき	祐希	固有人名
おおくぼゆうき	大久保裕樹	固有一般
おおくぼよしと	大久保嘉人	固有一般
よしと	嘉人	固有人名
おおくまけんた	大熊健太	固有一般
おおくまゆうじ	大熊裕司	固有一般
おおくらさとし	大倉智	固有一般
さとし	智	固有人名
おおくらまぁしゅん	大倉舞駿	固有一般
まぁしゅん	舞駿	固有人名
おおぐししょうへい	大串昇平	固有一般
おおぐろまさし	大黒将志	固有一般
まさし	将志	固有人名
おおごしひろと	大越寛人	固有一般
ひろと	寛人	固有人名
おおさかあやと	逢坂文都	固有一般
あやと	文都	固有人名
おおさかひろと	逢坂大翔	固有一般
ひろと	大翔	固有人名
おおさきこうし	大崎航詩	固有一般
こうし	航詩	固有人名
おおさきしゅん	大崎舜	固有一般
しゅん	舜	固有人名
おおさきじゅんや	大﨑淳矢	固有一般
じゅんや	淳矢	固有人名
おおさきれお	大﨑玲央	固有一般
れお	玲央	固有人名
おおさこあおと	大迫蒼人	固有一般
あおと	蒼人	固有人名
おおさこあきら	大迫暁	固有一般
あきら	暁	固有人名
おおさこけいすけ	大迫敬介	固有一般
けいすけ	敬介	固有人名
おおさこのぞみ	大迫希	固有一般
のぞみ	希	固有人名
おおさこゆうや	大迫勇也	固有一般
ゆうや	勇也	固有人名
おおさこよしあき	大迫義明	固有一般
よしあき	義明	固有人名
おおさこるい	大迫塁	固有一般
るい	塁	固有人名
おさとこうま	大里皇馬	固有一般
こうま	皇馬	固有人名
おおさわうのん	大澤羽隠	固有一般
うのん	羽隠	固有人名
おおさわげんい	大澤元栄	固有一般
げんい	元栄	固有人名
おおさわしゅんた	大澤俊太	固有一般
おおさわともや	大澤朋也	固有一般
ともや	朋也	固有人名
おおさわともや	大沢朋也	固有一般
おおさわゆうき	大澤雄樹	固有一般
ゆうき	雄樹	固有人名
おしばかつとも	大柴克友	固有一般
かつとも	克友	固有人名
おしばけんじ	大柴健二	固有一般
おしまこうき	大島康樹	固有一般
こうき	康樹	固有人名
おしまたかし	大嶌貴	固有一般
たかし	貴	固有人名
おしまたかひろ	大島嵩弘	固有一般
たかひろ	嵩弘	固有人名
おしまつばさ	大島翼	固有一般
おしまはるき	大嶋春樹	固有一般
はるき	春樹	固有人名
おしまひでお	大島秀夫	固有一般
ひでお	秀夫	固有人名
おしまやすあき	大島康明	固有一般
やすあき	康明	固有人名
おしまりょうた	大島僚太	固有一般
りょうた	僚太	固有人名
おおしろけい	大城 蛍	固有一般
おおしろゆうと	大城佑斗	固有一般
ゆうと	佑斗	固有人名
おおすぎさとし	大杉啓	固有一般
さとし	啓	固有人名
おおすぎまさと	大杉誠人	固有一般
まさと	誠人	固有人名
おおぜきけんと	大関健斗	固有一般
おおぜきゆうと	大関友翔	固有一般
ゆうと	友翔	固有人名
おおそねこうた	大曽根広汰	固有一般
こうた	広汰	固有人名
おおたかずき	太田一輝	固有一般
おおたがくじ	太田岳志	固有一般
がくじ	岳志	固有人名
おおたけいすけ	太田圭輔	固有一般
けいすけ	圭輔	固有人名
おおたけいすけ	太田恵介	固有一般
けいすけ	恵介	固有人名
おおたけんご	太田賢吾	固有一般
けんご	賢吾	固有人名
おおたこうすけ	太田宏介	固有一般
こうすけ	宏介	固有人名
おおたこうすけ	太田康介	固有一般
おおたしゅうすけ	太田修介	固有一般
しゅうすけ	修介	固有人名
おおたしゅんすけ	大田隼輔	固有一般
しゅんすけ	隼輔	固有人名
おおたそま	大田湊真	固有一般
そま	湊真	固有人名
おおたたかみつ	太田貴光	固有一般
たかみつ	貴光	固有人名
おおたてつろう	太田徹郎	固有一般
てつろう	徹郎	固有人名
おおたなるみ	太田成美	固有一般
なるみ	成美	固有人名
おおたはると	太田陽斗	固有一般
はると	陽斗	固有人名
おおたひろかず	太田裕和	固有一般
ひろかず	裕和	固有人名
おおたまさひろ	太田昌宏	固有一般
まさひろ	昌宏	固有人名
おおたまさゆき	太田雅之	固有一般
まさゆき	雅之	固有人名
おおたよしあき	太田吉彰	固有一般
よしあき	吉彰	固有人名
おおたりゅうのすけ	太田龍之介	固有一般
おおたわたる	太田渉	固有一般
おおたけしょうご	大竹将吾	固有一般
おおたけたくま	大嶽拓馬	固有一般
おおたけなおと	大嶽直人	固有一般
おおたけまさと	大嶽真人	固有一般
まさと	真人	固有人名
おおたけゆうしん	大竹優心	固有一般
ゆうしん	優心	固有人名
おおたけゆうせい	大竹悠聖	固有一般
ゆうせい	悠聖	固有人名
おおたけようへい	大竹洋平	固有一般
ようへい	洋平	固有人名
おおたけりゅうと	大竹隆人	固有一般
おおたにけいし	大谷圭志	固有一般
けいし	圭志	固有人名
おおたにこうき	大谷幸輝	固有一般
おおたにたけひろ	大谷武大	固有一般
たけひろ	武大	固有人名
おおたになおき	大谷尚輝	固有一般
なおき	尚輝	固有人名
おおたにはやと	大谷駿斗	固有一般
おおたにひでかず	大谷秀和	固有一般
ひでかず	秀和	固有人名
おおたにまさし	大谷真史	固有一般
まさし	真史	固有人名
おおたにまさし	大谷昌司	固有一般
まさし	昌司	固有人名
おおつひびき	大津響輝	固有一般
ひびき	響輝	固有人名
おおつゆうき	大津祐樹	固有一般
おおつゆうわ	大津佑和	固有一般
ゆうわ	佑和	固有人名
おおつようせい	大津耀誠	固有一般
ようせい	耀誠	固有人名
おおつかかずゆき	大塚和征	固有一般
かずゆき	和征	固有人名
おおつかしょう	大塚翔	固有一般
おおつかしょうた	大塚翔太	固有一般
おおつかしょうへい	大塚翔平	固有一般
おおつかしんじ	大塚真司	固有一般
しんじ	真司	固有人名
おおつかたくみ	大塚拓海	固有一般
おおつかひろと	大塚尋斗	固有一般
ひろと	尋斗	固有人名
おおつきしゅうへい	大槻周平	固有一般
しゅうへい	周平	固有人名
おおつきともや	大槻智也	固有一般
おおつきひろし	大槻紘士	固有一般
ひろし	紘士	固有人名
おおつきゆうへい	大槻優平	固有一般
ゆうへい	優平	固有人名
おおつぼとい	大坪十維	固有一般
とい	十維	固有人名
おおつぼひろかず	大坪博和	固有一般
ひろかず	博和	固有人名
おおともさとし	大友慧	固有一般
さとし	慧	固有人名
おおともちひろ	大友千裕	固有一般
ちひろ	千裕	固有人名
おおともゆうや	大友侑也	固有一般
ゆうや	侑也	固有人名
おおともりゅうすけ	大友竜輔	固有一般
りゅうすけ	竜輔	固有人名
おおにしこうじ	大西孝治	固有一般
こうじ	孝治	固有人名
おおにししょうご	大西勝俉	固有一般
しょうご	勝俉	固有人名
おおにししょうや	大西翔也	固有一般
しょうや	翔也	固有人名
おおにしたかし	大西貴	固有一般
おおにしたくま	大西拓真	固有一般
おおにしまさや	大西聖哉	固有一般
まさや	聖哉	固有人名
おおにしまさゆき	大西昌之	固有一般
まさゆき	昌之	固有人名
おおにしゆうき	大西勇輝	固有一般
おおにしようへい	大西容平	固有一般
ようへい	容平	固有人名
おおにしりょうたろう	大西遼太郎	固有一般
おおのかける	大野海翔	固有一般
かける	海翔	固有人名
おおのかずなり	大野和成	固有一般
おおのけいすけ	大野敬介	固有一般
おおのこうしょう	大野晃政	固有一般
こうしょう	晃政	固有人名
おおのこうへい	大野耕平	固有一般
おおのしゅうと	大野秀和	固有一般
しゅうと	秀和	固有人名
おおのしゅんぞう	大野俊三	固有一般
しゅんぞう	俊三	固有人名
おおのしんり	大野榛里	固有一般
しんり	榛里	固有人名
おおのちょるふぁん	大野哲煥	固有一般
ちょるふぁん	哲煥	固有人名
おおのつよし	大野剛	固有一般
つよし	剛	固有人名
おおのはるたか	大野敏隆	固有一般
はるたか	敏隆	固有人名
おおのゆうや	大野佑哉	固有一般
おおのようへい	大野耀平	固有一般
ようへい	耀平	固有人名
おおのよしふみ	大野貴史	固有一般
よしふみ	貴史	固有人名
おおはしあきよし	大橋昭好	固有一般
あきよし	昭好	固有人名
おおはしこうた	大橋滉太	固有一般
こうた	滉太	固有人名
おおはしひさし	大橋尚志	固有一般
ひさし	尚志	固有人名
おおはしまさひろ	大橋正博	固有一般
まさひろ	正博	固有人名
おおはしもとふみ	大橋基史	固有一般
もとふみ	基史	固有人名
おおはしゆうき	大橋祐紀	固有一般
ゆうき	祐紀	固有人名
おおはしよしたか	大橋良隆	固有一般
よしたか	良隆	固有人名
おおはたあゆむ	大畑歩夢	固有一般
あゆむ	歩夢	固有人名
おおはたたくや	大畑拓也	固有一般
おおはたりゅうや	大畑隆也	固有一般
りゅうや	隆也	固有人名
おおはらしょうき	大原彰輝	固有一般
しょうき	彰輝	固有人名
おおはらたくひろ	大原卓丈	固有一般
たくひろ	卓丈	固有人名
おおはらゆうたろう	大原悠太朗	固有一般
ゆうたろう	悠太朗	固有人名
おおばあきら	大場啓	固有一般
あきら	啓	固有人名
おおばけんじ	大場健史	固有一般
けんじ	健史	固有人名
おおばりゅうせい	大峡龍聖	固有一般
りゅうせい	龍聖	固有人名
おおひらたくみ	大平卓海	固有一般
たくみ	卓海	固有人名
おおぶしゅん	大武峻	固有一般
おおぶちらいじゅ	大渕来珠	固有一般
らいじゅ	来珠	固有人名
おおほりりょうのすけ	大堀亮之介	固有一般
りょうのすけ	亮之介	固有人名
おおまえげんき	大前元紀	固有一般
げんき	元紀	固有人名
おおまちしょうご	大町将梧	固有一般
しょうご	将梧	固有人名
おおみちひろゆき	大道広幸	固有一般
ひろゆき	広幸	固有人名
おおみなみたくま	大南拓磨	固有一般
おおむらこうすけ	大村康輔	固有一般
こうすけ	康輔	固有人名
おおもとただてる	大本忠輝	固有一般
ただてる	忠輝	固有人名
おおもとともや	大本智也	固有一般
おおもとゆうき	大本祐槻	固有一般
ゆうき	祐槻	固有人名
おおももかいと	大桃海斗	固有一般
おおももれおん	大桃怜音	固有一般
れおん	怜音	固有人名
おおもりけんさく	大森健作	固有一般
けんさく	健作	固有人名
おおもりこうたろう	大森晃太郎	固有一般
こうたろう	晃太郎	固有人名
おおもりしょう	大森渚生	固有一般
しょう	渚生	固有人名
おおもりしんご	大森真吾	固有一般
おおもりだいち	大森大地	固有一般
おおもりひろき	大森啓生	固有一般
ひろき	啓生	固有人名
おおもりひろし	大森博	固有一般
ひろし	博	固有人名
おおもりまさゆき	大森征之	固有一般
まさゆき	征之	固有人名
おおもりりお	大森理生	固有一般
りお	理生	固有人名
おおもりりょう	大森涼	固有一般
おおやつばさ	大屋翼	固有一般
おおやまきょうへい	大山恭平	固有一般
おおやまけいすけ	大山啓輔	固有一般
けいすけ	啓輔	固有人名
おおやまこうせい	大山晃生	固有一般
おおやましゅんすけ	大山俊輔	固有一般
しゅんすけ	俊輔	固有人名
おおやませいな	大山晟那	固有一般
せいな	晟那	固有人名
おおやまなおひろ	大山直大	固有一般
なおひろ	直大	固有人名
おおやまむさし	大山武蔵	固有一般
むさし	武蔵	固有人名
おおわだまさし	大和田真史	固有一般
おかてっぺい	岡哲平	固有一般
てっぺい	哲平	固有人名
おかひでき	岡英輝	固有一般
ひでき	英輝	固有人名
おかひろき	岡大生	固有一般
ひろき	大生	固有人名
おかよしき	岡佳樹	固有一般
よしき	佳樹	固有人名
おかざきかずや	岡﨑 和也	固有一般
おかざきけんや	岡﨑 建哉	固有一般
おかざきしんじ	岡崎慎司	固有一般
しんじ	慎司	固有人名
おかざきとらたろう	岡崎寅太郎	固有一般
とらたろう	寅太郎	固有人名
おかざきまこと	岡崎慎	固有一般
おかざきりょうへい	岡﨑亮平	固有一般
りょうへい	亮平	固有人名
おかざわこうせい	岡澤昂星	固有一般
こうせい	昂星	固有人名
おかじまきよのぶ	岡島清延	固有一般
きよのぶ	清延	固有人名
おかだあおい	岡田蒼生	固有一般
おかだあきひさ	岡田明久	固有一般
あきひさ	明久	固有人名
おかだしゅ	岡田珠羽	固有一般
しゅ	珠羽	固有人名
おかだしょうへい	岡田翔平	固有一般
おかだしんじ	岡田慎司	固有一般
おかだたける	岡田武瑠	固有一般
たける	武瑠	固有人名
おかだだい	岡田大	固有一般
だい	大	固有人名
おかだつばさ	岡田翼	固有一般
おかだなおひこ	岡田直彦	固有一般
なおひこ	直彦	固有人名
おかだやまと	岡田大和	固有一般
やまと	大和	固有人名
おかだゆうき	岡田優希	固有一般
ゆうき	優希	固有人名
おかだゆうき	岡田佑樹	固有一般
ゆうき	佑樹	固有人名
おかだゆうせい	岡田祐政	固有一般
ゆうせい	祐政	固有人名
おかだりゅう	岡田隆	固有一般
りゅう	隆	固有人名
おかだりゅうじ	岡田竜二	固有一般
りゅうじ	竜二	固有人名
おかだりょうた	岡田亮太	固有一般
おかなかはやと	岡中勇人	固有一般
はやと	勇人	固有人名
おかにしこうすけ	岡西宏祐	固有一般
こうすけ	宏祐	固有人名
おかにわしゅうと	岡庭愁人	固有一般
しゅうと	愁人	固有人名
おかにわゆうき	岡庭裕貴	固有一般
おかねなおや	岡根直哉	固有一般
おかのしゅうた	岡野周太	固有一般
しゅうた	周太	固有人名
おかのじゅん	岡野洵	固有一般
じゅん	洵	固有人名
おかのまさゆき	岡野雅行	固有一般
まさゆき	雅行	固有人名
おかのりんぺい	岡野凜平	固有一般
りんぺい	凜平	固有人名
おかべせな	岡部聖南	固有一般
せな	聖南	固有人名
おかむらかずや	岡村和哉	固有一般
かずや	和哉	固有人名
おかむらしゅうや	岡村修哉	固有一般
しゅうや	修哉	固有人名
おかむらだいはち	岡村大八	固有一般
だいはち	大八	固有人名
おかむらよしき	岡村宜城	固有一般
よしき	宜城	固有人名
おかもとかずま	岡本一真	固有一般
かずま	一真	固有人名
おかもとがく	岡本岳	固有一般
がく	岳	固有人名
おかもとこうじ	岡本浩司	固有一般
おかもとこたろう	岡本虎太郎	固有一般
こたろう	虎太郎	固有人名
おかもとしょうせい	岡本將成	固有一般
しょうせい	將成	固有人名
おかもとそうた	岡本壮太	固有一般
そうた	壮太	固有人名
おかもとたいよう	岡本泰陽	固有一般
たいよう	泰陽	固有人名
おかもとたくや	岡本拓也	固有一般
おかもとたけし	岡本剛史	固有一般
たけし	剛史	固有人名
おかもとたつや	岡本達也	固有一般
おかもとだいち	岡本大知	固有一般
おかもとだいな	岡本大和	固有一般
だいな	大和	固有人名
おかもとともたか	岡本知剛	固有一般
ともたか	知剛	固有人名
おかもとはやと	岡元勇人	固有一般
おかもとひでや	岡本英也	固有一般
ひでや	英也	固有人名
おかもとまさいろ	岡本昌弘	固有一般
まさいろ	昌弘	固有人名
おかもとみちや	岡本享也	固有一般
みちや	享也	固有人名
おかもとやすあき	岡本賢明	固有一般
やすあき	賢明	固有人名
おかもとゆうき	岡本勇輝	固有一般
おかもとりく	岡本陸	固有一般
おかもとりゅうご	岡本隆吾	固有一般
りゅうご	隆吾	固有人名
おかもとりゅうのすけ	岡本竜之介	固有一般
りゅうのすけ	竜之介	固有人名
おかやまかずき	岡山和輝	固有一般
かずき	和輝	固有人名
おかやまかずなり	岡山一成	固有一般
かずなり	一成	固有人名
おかやまてつや	岡山哲也	固有一般
おがさわらけいすけ	小笠原佳祐	固有一般
けいすけ	佳祐	固有人名
おがさわらけんせい	小笠原賢聖	固有一般
けんせい	賢聖	固有人名
おがさわらみつお	小笠原満男	固有一般
みつお	満男	固有人名
おがさわらゆうせい	小笠原侑生	固有一般
ゆうせい	侑生	固有人名
おがしわつよし	小柏剛	固有一般
おがわえんはる	小川エンハル	固有一般
えんはる	エンハル	固有人名
おがわかいせい	小川開世	固有一般
かいせい	開世	固有人名
おがわけいじろう	小川慶治朗	固有一般
けいじろう	慶治朗	固有人名
おがわこうき	小川航基	固有一般
こうき	航基	固有人名
おがわしほ	小河詩朋	固有一般
しほ	詩朋	固有人名
おがわじょう	尾川丈	固有一般
おがわせいいち	小川誠一	固有一般
せいいち	誠一	固有人名
おがわせな	小川聖凪	固有一般
せな	聖凪	固有人名
おがわそら	小川大空	固有一般
そら	大空	固有人名
おがわたくみ	小川巧	固有一般
おがわたつや	小川達也	固有一般
おがわだいき	小川大貴	固有一般
おがわなおき	小川直毅	固有一般
なおき	直毅	固有人名
おがわひかり	小川創煌	固有一般
ひかり	創煌	固有人名
おがわひろき	小川紘生	固有一般
ひろき	紘生	固有人名
おがわまさき	小川雅己	固有一般
おがわまさき	小川真輝	固有一般
おがわゆうすけ	小川優介	固有一般
おがわゆうだい	小川雄大	固有一般
おがわよしずみ	小川佳純	固有一般
よしずみ	佳純	固有人名
おがわりょうや	小川諒也	固有一般
りょうや	諒也	固有人名
おがわりん	小川麟	固有一般
りん	麟	固有人名
おきかいと	起海斗	固有一般
おきゆうや	沖悠哉	固有一般
おきざきはやて	沖崎颯	固有一般
おきつだいぞう	興津大三	固有一般
だいぞう	大三	固有人名
おきのまさき	沖野将基	固有一般
まさき	将基	固有人名
おぎこうた	荻晃太	固有一般
こうた	晃太	固有人名
おぎそはるき	小木曽春樹	固有一般
おぎのこうた	荻野広大	固有一般
こうた	広大	固有人名
おぎのもとのぶ	荻野元伸	固有一般
もとのぶ	元伸	固有人名
おぎはらけいた	荻原渓太	固有一般
おぎわらたくや	荻原拓也	固有一般
おくだいすけ	奥大介	固有一般
おくいひろき	奥井大貴	固有一般
ひろき	大貴	固有人名
おくいりょう	奥井諒	固有一般
おくがわまさや	奥川雅也	固有一般
まさや	雅也	固有人名
おくだこうや	奥田晃也	固有一般
こうや	晃也	固有人名
おくだたつろう	奥田達朗	固有一般
おくだだいじろう	奥田大二郎	固有一般
だいじろう	大二郎	固有人名
おくだはやと	奥田勇斗	固有一般
はやと	勇斗	固有人名
おくだひろき	奥田裕貴	固有一般
ひろき	裕貴	固有人名
おくだゆうだい	奥田雄大	固有一般
おくつれいた	奥津玲太	固有一般
れいた	玲太	固有人名
おくぬきかんじ	奥抜侃志	固有一般
かんじ	侃志	固有人名
おくのこうへい	奥野耕平	固有一般
おくのしんたろう	奥野慎太郎	固有一般
しんたろう	慎太郎	固有人名
おくのせいいちろう	奥野誠一郎	固有一般
せいいちろう	誠一郎	固有人名
おくのひろあき	奥埜博亮	固有一般
ひろあき	博亮	固有人名
おくのまさあき	奥野雅晶	固有一般
まさあき	雅晶	固有人名
おくのりょうすけ	奥野僚右	固有一般
りょうすけ	僚右	固有人名
おくはらたかし	奥原崇	固有一般
たかし	崇	固有人名
おくみやだいち	屋宮大地	固有一般
おくむらこうじ	奥村晃司	固有一般
こうじ	晃司	固有人名
おくむらじん	奥村仁	固有一般
おくむらみき	奥村海生	固有一般
みき	海生	固有人名
おくむらよしゆき	奥村慶之	固有一般
よしゆき	慶之	固有人名
おくもとたいせい	奥元大晴	固有一般
おくやまたくろう	奥山卓廊	固有一般
たくろう	卓廊	固有人名
おくやままさゆき	奥山政幸	固有一般
まさゆき	政幸	固有人名
おくやまやすひろ	奥山泰裕	固有一般
やすひろ	泰裕	固有人名
おくやまようへい	奥山洋平	固有一般
おくやまりく	奥山璃空	固有一般
りく	璃空	固有人名
おぐらかいせい	小椋凱生	固有一般
かいせい	凱生	固有人名
おぐらしょうへい	小椋祥平	固有一般
しょうへい	祥平	固有人名
おぐらたかふみ	小倉隆史	固有一般
たかふみ	隆史	固有人名
おぐらてつや	小椋哲也	固有一般
おぐらひなた	小倉陽太	固有一般
ひなた	陽太	固有人名
おぐばぐしょうせい	オグヴァーグ翔星	固有一般
しょうせい	翔星	固有人名
おさだみちやす	長田道泰	固有一般
みちやす	道泰	固有人名
おさだりょうへい	長田涼平	固有一般
おさないたかや	小山内貴哉	固有一般
おざきえいいちろう	尾崎瑛一郎	固有一般
えいいちろう	瑛一郎	固有人名
おざきかずお	尾崎加寿夫	固有一般
かずお	加寿夫	固有人名
おざきゆうし	尾﨑勇史	固有一般
ゆうし	勇史	固有人名
おざきゆうじ	尾崎雄二	固有一般
ゆうじ	雄二	固有人名
おざきゆうせい	尾崎優成	固有一般
ゆうせい	優成	固有人名
おざわあきひと	小澤章人	固有一般
あきひと	章人	固有人名
おざわしゅうたろう	小澤秀太郎	固有一般
しゅうたろう	秀太郎	固有人名
おざわしゅんすけ	小澤俊介	固有一般
おざわたくみ	小澤巧	固有一般
おざわつかさ	小澤司	固有一般
おざわはるき	小澤晴樹	固有一般
おざわひかる	小澤光	固有一般
おざわひであき	小澤英明	固有一般
ひであき	英明	固有人名
おざわひであつ	小澤秀充	固有一般
ひであつ	秀充	固有人名
おざわゆうき	小澤雄希	固有一般
ゆうき	雄希	固有人名
おしくぼしおん	押久保汐音	固有一般
しおん	汐音	固有人名
おしだにゆうき	押谷祐樹	固有一般
おしとみたいき	押富大輝	固有一般
たいき	大輝	固有人名
おじまとおる	小島徹	固有一般
おじまみずき	小島瑞來	固有一般
みずき	瑞來	固有人名
おぜきようせい	小関陽星	固有一般
ようせい	陽星	固有人名
おたぎりみちはる	小田切道治	固有一般
みちはる	道治	固有人名
おだいつき	小田逸稀	固有一般
いつき	逸稀	固有人名
おだそう	小田奏	固有一般
そう	奏	固有人名
おだゆうたろう	小田裕太郎	固有一般
ゆうたろう	裕太郎	固有人名
おだがきこうき	小田垣皓己	固有一般
こうき	皓己	固有人名
おだがきめぐる	小田垣旋	固有一般
めぐる	旋	固有人名
おだじまたかゆき	小田島隆幸	固有一般
たかゆき	隆幸	固有人名
おだじまりょう	小田島怜	固有一般
りょう	怜	固有人名
おだじまれい	小田島怜	固有一般
おちはやと	越智隼人	固有一般
おちりょうすけ	越智亮介	固有一般
りょうすけ	亮介	固有人名
おちあいたけと	落合毅人	固有一般
たけと	毅人	固有人名
おちあいまさゆき	落合正幸	固有一般
まさゆき	正幸	固有人名
おちあいりく	落合陸	固有一般
おちいずみしょうま	音泉翔眞	固有一般
しょうま	翔眞	固有人名
おないうあど	オナイウ阿道	固有一般
あど	阿道	固有人名
おないうげおじ	オナイウ情滋	固有一般
げおじ	情滋	固有人名
おながひじり	翁長聖	固有一般
ひじり	聖	固有人名
おにきとおる	鬼木達	固有一般
とおる	達	固有人名
おにきはやと	鬼木颯都	固有一般
はやと	颯都	固有人名
おにづかてんむ	鬼塚天夢	固有一般
てんむ	天夢	固有人名
おぬまあきと	小沼昭人	固有一般
あきと	昭人	固有人名
おぬまたつき	小沼樹輝	固有一般
たつき	樹輝	固有人名
おのあきみち	小野耀路	固有一般
あきみち	耀路	固有人名
おのけいすけ	小野敬輔	固有一般
おのこうた	小野広太	固有一般
こうた	広太	固有人名
おのしゅんすけ	小野俊輔	固有一般
おのしんぎ	小野信義	固有一般
しんぎ	信義	固有人名
おのしんじ	小野伸二	固有一般
しんじ	伸二	固有人名
おのたかよし	小野隆儀	固有一般
たかよし	隆儀	固有人名
おのともよし	小野智吉	固有一般
ともよし	智吉	固有人名
おのなるむ	小野成夢	固有一般
なるむ	成夢	固有人名
おのひろのぶ	小野博信	固有一般
ひろのぶ	博信	固有人名
おのまさひと	小野雅史	固有一般
まさひと	雅史	固有人名
おのゆうじ	小野裕二	固有一般
おのゆうと	小野悠斗	固有一般
ゆうと	悠斗	固有人名
おのゆうへい	小野雄平	固有一般
ゆうへい	雄平	固有人名
おのりょうや	小野凌也	固有一般
りょうや	凌也	固有人名
おのえしげお	尾上恵生	固有一般
しげお	恵生	固有人名
おのえゆうせい	尾上瑠聖	固有一般
ゆうせい	瑠聖	固有人名
おのえゆうや	尾上勇也	固有一般
おのざわとしき	斧澤隼輝	固有一般
としき	隼輝	固有人名
おのせこうすけ	小野瀬康介	固有一般
おのぜきとらのすけ	小野関虎之介	固有一般
とらのすけ	虎之介	固有人名
おのだまさひと	小野田将人	固有一般
まさひと	将人	固有人名
おのでらけんと	小野寺建人	固有一般
けんと	建人	固有人名
おのでらけんや	小野寺健也	固有一般
けんや	健也	固有人名
おのでらたくみ	小野寺巧	固有一般
おのでらたつや	小野寺達也	固有一般
おのでられん	小野寺蓮	固有一般
おのはらかずや	小野原和哉	固有一般
おはらもとき	小原基樹	固有一般
もとき	基樹	固有人名
おばたえいしょう	小幡瑛成	固有一般
えいしょう	瑛成	固有人名
おばたじゅんぺい	小幡純平	固有一般
おぬまゆうま	小畑裕馬	固有一般
ゆうま	裕馬	固有人名
おばたけてんと	小畠伝人	固有一般
てんと	伝人	固有人名
おびらんでぃーえめか	小枇ランディーエメカ	固有一般
おぼなやろみお	オボナヤ朗充於	固有一般
ろみお	朗充於	固有人名
おまたひろゆき	尾亦弘友希	固有一般
ひろゆき	弘友希	固有人名
おみけいご	小見恵吾	固有一般
けいご	恵吾	固有人名
おみとしや	尾身俊哉	固有一般
としや	俊哉	固有人名
おむらのりお	小村徳男	固有一般
のりお	徳男	固有人名
おむらわたる	尾村航	固有一般
おもてはらげんた	表原玄太	固有一般
げんた	玄太	固有人名
おもとけい	尾本敬	固有一般
けい	敬	固有人名
おもやゆくと	面矢行斗	固有一般
ゆくと	行斗	固有人名
おりぐちてるき	折口輝樹	固有一般
てるき	輝樹	固有人名
じゃしゅうぜん	賈秀全	固有一般
しゅうぜん	秀全	固有人名
かいけんたろう	甲斐健太郎	固有一般
かいてつし	甲斐鉄士	固有一般
てつし	鉄士	固有人名
かいもとけいじ	海本慶治	固有一般
けいじ	慶治	固有人名
かいもとけいたろう	海本慶太朗	固有一般
けいたろう	慶太朗	固有人名
かいもとこうじろう	海本幸治郎	固有一般
こうじろう	幸治郎	固有人名
かえつひであき	嘉悦秀明	固有一般
かがけんいち	加賀健一	固有一般
かがみけんすけ	加賀見健介	固有一般
けんすけ	健介	固有人名
かがみしょう	加賀美翔	固有一般
かがみとい	加々美登生	固有一般
とい	登生	固有人名
かがわしんじ	香川真司	固有一般
かがわみきや	香川幹弥	固有一般
かがわゆうき	香川勇気	固有一般
ゆうき	勇気	固有人名
かきうちしょうた	垣内祥大	固有一般
しょうた	祥大	固有人名
かきうちゆうじ	垣内友二	固有一般
ゆうじ	友二	固有人名
かきぎりょうすけ	柿木亮介	固有一般
かきたゆうき	垣田裕暉	固有一般
ゆうき	裕暉	固有人名
かきたによういちろう	柿谷曜一朗	固有一般
よういちろう	曜一朗	固有人名
かきねたくや	垣根拓也	固有一般
かきもとけんた	柿本健太	固有一般
かきもとしょうた	柿本聖太	固有一般
しょうた	聖太	固有人名
かきもとみちあき	柿本倫明	固有一般
みちあき	倫明	固有人名
かぎやまけいじ	鍵山慶司	固有一般
けいじ	慶司	固有人名
かくてひ	郭 泰輝	固有一般
かくたくんぺい	角田薫平	固有一般
くんぺい	薫平	固有人名
かくだまこと	角田誠	固有一般
かくらいたくや	加倉井拓弥	固有一般
たくや	拓弥	固有人名
かけがわまこと	掛川誠	固有一般
かけひゆう	懸樋優	固有一般
かげやまけんじ	景山健司	固有一般
けんじ	健司	固有人名
かげやまけんぞう	影山兼三	固有一般
けんぞう	兼三	固有人名
かげやまこうた	影山倖大	固有一般
こうた	倖大	固有人名
かげやまたかし	影山貴志	固有一般
かげやままさなが	影山雅永	固有一般
まさなが	雅永	固有人名
かげやまよしたか	影山由高	固有一般
よしたか	由高	固有人名
かげやまるいと	影山塁飛	固有一般
るいと	塁飛	固有人名
かこいけんたろう	圍謙太朗	固有一般
けんたろう	謙太朗	固有人名
かさがわえいた	笠川永太	固有一般
えいた	永太	固有人名
かさぎゆず	笠木優寿	固有一般
ゆず	優寿	固有人名
かさはらすなお	笠原淳	固有一般
すなお	淳	固有人名
かさはらそうた	笠原宗太	固有一般
そうた	宗太	固有人名
かさはらたかし	笠原昂史	固有一般
たかし	昂史	固有人名
かさはらりょうや	笠原綾也	固有一般
りょうや	綾也	固有人名
かさやなぎつばさ	笠柳翼	固有一般
かざまこうき	風間宏希	固有一般
こうき	宏希	固有人名
かざまこうや	風間宏矢	固有一般
こうや	宏矢	固有人名
かざまやひろ	風間八宏	固有一般
やひろ	八宏	固有人名
かざわひゆ	賀澤陽友	固有一般
ひゆ	陽友	固有人名
かしざきけいた	樫崎桂太	固有一般
けいた	桂太	固有人名
かしはらゆうせい	栢原悠聖	固有一般
かしわよしふみ	柏好文	固有一般
よしふみ	好文	固有人名
かしわぎひいろ	柏木陽良	固有一般
ひいろ	陽良	固有人名
かしわぎようすけ	柏木陽介	固有一般
かしわせさとる	柏瀬暁	固有一般
かじりょう	加地亮	固有一般
りょう	亮	固有人名
かじいかつし	梶居勝志	固有一般
かつし	勝志	固有人名
かじうらゆうき	梶浦勇輝	固有一般
かじかわゆうじ	梶川裕嗣	固有一般
ゆうじ	裕嗣	固有人名
かじかわりょうた	梶川諒太	固有一般
りょうた	諒太	固有人名
かじのさとし	梶野智	固有一般
かじのともゆき	梶野智幸	固有一般
ともゆき	智幸	固有人名
かじはらけいた	梶原啓太	固有一般
かじはらはると	梶原陽翔	固有一般
かじやまさひと	梶谷政仁	固有一般
まさひと	政仁	固有人名
かじやまかんた	梶山幹太	固有一般
かんた	幹太	固有人名
かじやまよういち	梶山洋一	固有一般
よういち	洋一	固有人名
かじやまようへい	梶山陽平	固有一般
かじわらけいた	梶原慧汰	固有一般
けいた	慧汰	固有人名
かじわらゆうきや	梶原夕希也	固有一般
ゆうきや	夕希也	固有人名
かずままさひろ	數馬正浩	固有一般
まさひろ	正浩	固有人名
かせなおき	加瀬直輝	固有一般
かたいたくみ	片井巧	固有一般
かたおかこうじ	片岡功二	固有一般
こうじ	功二	固有人名
かたおかそう	片岡爽	固有一般
かたおかつばさ	片岡翼	固有一般
かたおかようすけ	片岡洋介	固有一般
ようすけ	洋介	固有人名
かたがみたいそん	片上泰尊	固有一般
たいそん	泰尊	固有人名
かたぎやすき	片木泰希	固有一般
やすき	泰希	固有人名
かたぎりあつし	片桐淳至	固有一般
あつし	淳至	固有人名
かたくらせいや	片倉誠也	固有一般
せいや	誠也	固有人名
かたのひろみち	片野寛理	固有一般
ひろみち	寛理	固有人名
かたのさかともひろ	片野坂知宏	固有一般
ともひろ	知宏	固有人名
かたびらともゆき	帷智行	固有一般
ともゆき	智行	固有人名
かたふちこういちろう	片渕浩一郎	固有一般
こういちろう	浩一郎	固有人名
かたやまえいいち	片山瑛一	固有一般
えいいち	瑛一	固有人名
かたやましょうすけ	片山奨典	固有一般
しょうすけ	奨典	固有人名
かたやまひろと	片山寛人	固有一般
かたやままさと	片山真人	固有一般
かだじゅんや	加田淳哉	固有一般
じゅんや	淳哉	固有人名
かつきしょうや	勝木翔也	固有一般
かつべひなた	勝部陽太	固有一般
かつまたよしのり	勝又慶典	固有一般
よしのり	慶典	固有人名
かつやとしひさ	勝矢寿延	固有一般
としひさ	寿延	固有人名
かつらひでき	桂秀樹	固有一般
かつらりくと	桂陸人	固有一般
かとういっせい	加藤壱盛	固有一般
いっせい	壱盛	固有人名
かとうけんと	加藤健人	固有一般
けんと	健人	固有人名
かとうげん	加藤玄	固有一般
げん	玄	固有人名
かとうこうけん	加藤弘堅	固有一般
こうけん	弘堅	固有人名
かとうこうへい	加藤恒平	固有一般
こうへい	恒平	固有人名
かとうしんたろう	加藤慎太郎	固有一般
かとうしんや	加藤慎也	固有一般
かとうじゅんや	加藤潤也	固有一般
じゅんや	潤也	固有人名
かとうたいき	加藤大樹	固有一般
かとうたいち	加藤大智	固有一般
たいち	大智	固有人名
かとうたかとら	加藤嵩寅	固有一般
たかとら	嵩寅	固有人名
かとうたくと	加藤匠人	固有一般
たくと	匠人	固有人名
かとうたくみ	加藤拓己	固有一般
たくみ	拓己	固有人名
かとうたけひろ	加藤豪宏	固有一般
たけひろ	豪宏	固有人名
かとうだいき	加藤大喜	固有一般
だいき	大喜	固有人名
かとうだいし	加藤大志	固有一般
だいし	大志	固有人名
かとうだいすけ	加藤大育	固有一般
だいすけ	大育	固有人名
かとうだいや	加藤大也	固有一般
だいや	大也	固有人名
かとうちはる	加藤智陽	固有一般
ちはる	智陽	固有人名
かとうちひろ	加藤千尋	固有一般
ちひろ	千尋	固有人名
かとうてつや	加藤徹也	固有一般
てつや	徹也	固有人名
かとうとおる	加藤徹	固有一般
かとうとしかず	加藤寿一	固有一般
としかず	寿一	固有人名
かとうとものしん	加藤友乃晋	固有一般
とものしん	友乃晋	固有人名
かとうのぞむ	加藤望	固有一般
のぞむ	望	固有人名
かとうのぶひろ	加藤順大	固有一般
のぶひろ	順大	固有人名
かとうひさし	加藤久	固有一般
かとうひじり	加藤聖	固有一般
かとうひでのり	加藤秀典	固有一般
かとうひろき	加藤広樹	固有一般
ひろき	広樹	固有人名
かとうまさる	加藤大	固有一般
まさる	大	固有人名
かとうむつき	加藤陸次樹	固有一般
むつき	陸次樹	固有人名
かとうやすあき	加藤泰明	固有一般
やすあき	泰明	固有人名
かとうゆうき	加藤有輝	固有一般
ゆうき	有輝	固有人名
かとうゆうま	加藤悠馬	固有一般
ゆうま	悠馬	固有人名
かとうよしお	加藤好男	固有一般
よしお	好男	固有人名
かとうよしゆき	加藤善之	固有一般
よしゆき	善之	固有人名
かとうりゅうじ	加藤竜二	固有一般
かとうりょういち	加藤遼一	固有一般
りょういち	遼一	固有人名
かとうれん	加藤蓮	固有一般
かとうれんしょう	加藤蓮生	固有一般
れんしょう	蓮生	固有人名
かとりじゅん	香取潤	固有一般
かどぐちたいせい	角口大征	固有一般
たいせい	大征	固有人名
かどのしょうた	角野翔汰	固有一般
しょうた	翔汰	固有人名
かどわきはやと	門脇駿斗	固有一般
かないたかし	金井貢史	固有一般
たかし	貢史	固有人名
かないりゅうた	金井隆太	固有一般
りゅうた	隆太	固有人名
かないりょうた	金井亮太	固有一般
かながせじんと	金ヶ瀬仁人	固有一般
じんと	仁人	固有人名
かなくぼさい	金久保彩	固有一般
さい	彩	固有人名
かなくぼじゅん	金久保順	固有一般
じゅん	順	固有人名
かなぐちのぞむ	金口望	固有一般
かなざきむう	金崎夢生	固有一般
むう	夢生	固有人名
かなざわしん	金澤慎	固有一般
しん	慎	固有人名
かなざわじょう	金沢浄	固有一般
じょう	浄	固有人名
かなざわたかふみ	金澤崇文	固有一般
たかふみ	崇文	固有人名
かなざわひろまさ	金澤大将	固有一般
ひろまさ	大将	固有人名
かなざわりょう	金沢亮	固有一般
かなぞのひでたか	金園英学	固有一般
ひでたか	英学	固有人名
かなもりけんじ	金森健志	固有一般
けんじ	健志	固有人名
かなもりともや	金守智哉	固有一般
かなやまじゅんき	金山隼樹	固有一般
じゅんき	隼樹	固有人名
かにまさたか	可児壮隆	固有一般
まさたか	壮隆	固有人名
かぬまなおき	鹿沼直生	固有一般
なおき	直生	固有人名
かねいだいき	金井大樹	固有一般
かねうらまさき	金浦真樹	固有一般
まさき	真樹	固有人名
かねえだこうへい	金枝晃平	固有一般
かねこしょうた	金子翔太	固有一般
かねこせいじ	金古聖司	固有一般
せいじ	聖司	固有人名
かねこせいた	金子星太	固有一般
せいた	星太	固有人名
かねこそうた	金子颯太	固有一般
そうた	颯太	固有人名
かねこたいせい	金子大晟	固有一般
たいせい	大晟	固有人名
かねこたくろう	金子拓郎	固有一般
かねこだいき	金子大毅	固有一般
だいき	大毅	固有人名
かねこつよし	金子剛	固有一般
かねこひろき	金子弘樹	固有一般
かねこまこと	金子誠	固有一般
かねこまさひろ	金子昌広	固有一般
かねこゆうき	金子勇樹	固有一般
かねこゆうき	金子優希	固有一般
かねこゆたか	金子豊	固有一般
かねさかれいや	金坂励耶	固有一般
れいや	励耶	固有人名
かねだあきしげ	兼田亜季重	固有一般
あきしげ	亜季重	固有人名
かねだあすか	金田飛鳥	固有一般
あすか	飛鳥	固有人名
かねだやまと	金田大和	固有一般
かねもとけいた	金本圭太	固有一般
かねもとまさみつ	兼本正光	固有一般
まさみつ	正光	固有人名
かのかいせい	狩野海晟	固有一般
かいせい	海晟	固有人名
かのけんた	狩野健太	固有一般
かのうまさひろ	加納昌弘	固有一般
まさひろ	昌弘	固有人名
かのうれん	加納錬	固有一般
れん	錬	固有人名
かのしまゆう	彼島優	固有一般
かばやまりょうのすけ	樺山諒乃介	固有一般
りょうのすけ	諒乃介	固有人名
かぶらぎごう	鏑木豪	固有一般
ごう	豪	固有人名
かぶらぎみずき	鏑木瑞生	固有一般
かぶらぎとおる	鏑木享	固有一般
とおる	享	固有人名
かぶらぎりょうご	鏑木亮吾	固有一般
りょうご	亮吾	固有人名
かべみらん	加部未蘭	固有一般
かまたしょうま	鎌田翔雅	固有一般
しょうま	翔雅	固有人名
かまたじろう	鎌田次郎	固有一般
じろう	次郎	固有人名
かまたとらい	鎌田斗来	固有一般
とらい	斗来	固有人名
かまだしょうへい	鎌田祥平	固有一般
かまだだいち	鎌田大地	固有一般
かまだひろむ	鎌田大夢	固有一般
ひろむ	大夢	固有人名
かみおかともき	上岡朋樹	固有一般
ともき	朋樹	固有人名
かみかわたく	上川琢	固有一般
たく	琢	固有人名
かみがきりく	神垣陸	固有一般
かみがしましゅうや	上ヶ嶋柊也	固有一般
しゅうや	柊也	固有人名
かみがたようすけ	上形洋介	固有一般
かみささぬきまもる	上笹貫剣	固有一般
まもる	剣	固有人名
かみしまたくみ	上島拓巳	固有一般
かみじょうひろあき	上條宏晃	固有一般
ひろあき	宏晃	固有人名
かみぞのかずあき	上園和明	固有一般
かずあき	和明	固有人名
かみたじゅん	嘉味田隼	固有一般
かみにししゅんぺい	上西峻平	固有一般
しゅんぺい	峻平	固有人名
かみのりょうた	神野亮太	固有一般
かみひがしゆきと	上東悠樹斗	固有一般
ゆきと	悠樹斗	固有人名
かみふくもとなおと	上福元直人	固有一般
かみまるよいち	神丸洋一	固有一般
よいち	洋一	固有人名
かみむらしゅうへい	上村周平	固有一般
かみむらしょう	神村奨	固有一般
しょう	奨	固有人名
かみむらねお	上村音生	固有一般
ねお	音生	固有人名
かみむらゆうじ	上村祐司	固有一般
ゆうじ	祐司	固有人名
かみもとひろと	紙元大翔	固有一般
かみやかいと	神谷凱士	固有一般
かいと	凱士	固有人名
かみやしゅんや	神谷駿文	固有一般
しゅんや	駿文	固有人名
かみやゆうすけ	神谷悠介	固有一般
かみやゆうた	神谷優太	固有一般
かみやりょうと	神谷椋士	固有一般
りょうと	椋士	固有人名
かみやまきょうすけ	神山京右	固有一般
きょうすけ	京右	固有人名
かみやまりゅういち	神山竜一	固有一般
りゅういち	竜一	固有人名
かめかわまさし	亀川諒史	固有一般
まさし	諒史	固有人名
かめしましゅう	亀島周	固有一般
しゅう	周	固有人名
かめだこうき	亀田光貴	固有一般
こうき	光貴	固有人名
かめだたいが	亀田大河	固有一般
かもつよし	加茂剛	固有一般
かもがわしょう	鴨川奨	固有一般
かもしだたかし	鴨志田誉	固有一般
たかし	誉	固有人名
かもはらたつや	蒲原達也	固有一般
かやぬまゆうせい	萱沼優聖	固有一般
ゆうせい	優聖	固有人名
からしまけいじゅ	辛島啓珠	固有一般
けいじゅ	啓珠	固有人名
かりまいとわ	苅米飛和	固有一般
とわ	飛和	固有人名
かりまたあきと	狩俣瑛斗	固有一般
あきと	瑛斗	固有人名
かどなぜん	狩土名禅	固有一般
かるべりゅうたろう	苅部隆太郎	固有一般
りゅうたろう	隆太郎	固有人名
かるべわたる	軽部倭太琉	固有一般
わたる	倭太琉	固有人名
かわいあゆむ	川井歩	固有一般
あゆむ	歩	固有人名
かわいけんた	川井健太	固有一般
かわいこういち	川井光一	固有一般
こういち	光一	固有人名
かわいしゅうと	河合秀人	固有一般
しゅうと	秀人	固有人名
かわいしゅん	河合駿	固有一般
かわいたかやす	河合崇泰	固有一般
たかやす	崇泰	固有人名
かわいてつた	河井哲太	固有一般
てつた	哲太	固有人名
かわいとくも	川合徳孟	固有一般
とくも	徳孟	固有人名
かわいひなた	川合陽	固有一般
ひなた	陽	固有人名
かわいももたろう	川井桃太朗	固有一般
ももたろう	桃太朗	固有人名
かわいようすけ	河井陽介	固有一般
かわいりゅうじ	河合竜二	固有一般
かわいだりょうや	川井田稜弥	固有一般
りょうや	稜弥	固有人名
かわかつひろやす	川勝博康	固有一般
かわかみちえ	川上エドオジョン智慧	固有一般
かわかみこうき	川上航生	固有一般
こうき	航生	固有人名
かわかみこうへい	川上康平	固有一般
こうへい	康平	固有人名
かわかみしゅん	川上隼	固有一般
しゅん	隼	固有人名
かわかみしょうへい	河上将平	固有一般
しょうへい	将平	固有人名
かわかみしょうへい	川上翔平	固有一般
かわかみせいじ	川上盛司	固有一般
せいじ	盛司	固有人名
かわかみつばさ	川上翼	固有一般
かわかみのりひろ	川上典洋	固有一般
のりひろ	典洋	固有人名
かわかみゆうき	川上優樹	固有一般
ゆうき	優樹	固有人名
かわかみゆうと	川上悠斗	固有一般
かわかみよせい	川上陽星	固有一般
よせい	陽星	固有人名
かわかみりゅう	川上竜	固有一般
りゅう	竜	固有人名
かわきたゆうすけ	川北裕介	固有一般
ゆうすけ	裕介	固有人名
かわぎしゆうすけ	川岸祐輔	固有一般
かわぐちあきら	川口晃	固有一般
かわぐちかずや	川口和也	固有一般
かわぐちこうへい	川口航平	固有一般
かわぐちしんいち	河口真一	固有一般
しんいち	真一	固有人名
かわぐちそうすけ	川口蒼友	固有一般
そうすけ	蒼友	固有人名
かわぐちたくや	川口卓哉	固有一般
たくや	卓哉	固有人名
かわぐちなおき	川口尚紀	固有一般
なおき	尚紀	固有人名
かわぐちのぶお	川口信男	固有一般
のぶお	信男	固有人名
かわぐちまさし	川口真史	固有一般
かわぐちまさと	川口正人	固有一般
まさと	正人	固有人名
かわぐちゆうま	川口佑真	固有一般
ゆうま	佑真	固有人名
かわぐちよしかつ	川口能活	固有一般
よしかつ	能活	固有人名
かわさきあきひろ	川崎晶弘	固有一般
あきひろ	晶弘	固有人名
かわさきあつし	川﨑淳	固有一般
あつし	淳	固有人名
かわさきいっき	川﨑一輝	固有一般
いっき	一輝	固有人名
かわさきけんたろう	川崎健太郎	固有一般
かわさきしゅうへい	川﨑修平	固有一般
しゅうへい	修平	固有人名
かわさきそうた	川﨑 颯太	固有一般
かわさきもとき	川崎元気	固有一般
もとき	元気	固有人名
かわさきやすまさ	川﨑裕大	固有一般
やすまさ	裕大	固有人名
かわさきらい	川崎楽生	固有一般
らい	楽生	固有人名
かわさとこうたろう	川里光太郎	固有一般
こうたろう	光太郎	固有人名
かわしまえいじ	川島永嗣	固有一般
えいじ	永嗣	固有人名
かわしまこうき	川島康暉	固有一般
こうき	康暉	固有人名
かわしましんや	川島眞也	固有一般
しんや	眞也	固有人名
かわしまだいき	川島大輝	固有一般
かわしまだいち	川島大地	固有一般
かわしまとおる	川島透	固有一般
とおる	透	固有人名
かわしまのぶゆき	川島將	固有一般
のぶゆき	將	固有人名
かわしまみざき	川島みざき	固有一般
かわたあつひで	河田篤秀	固有一般
あつひで	篤秀	固有人名
かわたかずひろ	川田和宏	固有一般
かずひろ	和宏	固有人名
かわたけんと	川田拳登	固有一般
けんと	拳登	固有人名
かわたこうへい	河田晃兵	固有一般
こうへい	晃兵	固有人名
かわたしゅうへい	川田修平	固有一般
かわたになぎ	川谷凪	固有一般
なぎ	凪	固有人名
かわだなみひろ	河田波大	固有一般
なみひろ	波大	固有人名
かわだのぶしげ	川田信茂	固有一般
のぶしげ	信茂	固有人名
かわだりょうた	河田稜太	固有一般
りょうた	稜太	固有人名
かわづりょういち	河津良一	固有一般
りょういち	良一	固有人名
かわずめんあきなり	河面旺成	固有一般
かわとだいき	川戸大樹	固有一般
かわなかけんた	川中健太	固有一般
かわなべたかや	川辺隆弥	固有一般
たかや	隆弥	固有人名
かわなべりょうすけ	川鍋良祐	固有一般
りょうすけ	良祐	固有人名
かわなみおうじ	河波櫻士	固有一般
おうじ	櫻士	固有人名
かわなみごろう	川浪吾郎	固有一般
ごろう	吾郎	固有人名
かわにししょうた	川西翔太	固有一般
かわにしまこと	河西真	固有一般
まこと	真	固有人名
かわのかずまさ	河野和正	固有一般
かずまさ	和正	固有人名
かわのけんいち	河野健一	固有一般
かわのこうた	河野孝汰	固有一般
こうた	孝汰	固有人名
かわのしんいち	河野真一	固有一般
かわのたかし	河野貴志	固有一般
かわのひろき	河野広貴	固有一般
ひろき	広貴	固有人名
かわのりく	河野陸	固有一般
かわのりょうすけ	河野諒祐	固有一般
りょうすけ	諒祐	固有人名
かわはらかずひさ	河原和寿	固有一般
かずひさ	和寿	固有人名
かわはらしゅうごう	川原周剛	固有一般
しゅうごう	周剛	固有人名
かわはらそう	河原創	固有一般
そう	創	固有人名
かわはらたつや	川原達也	固有一般
かわはらなつき	川原那月	固有一般
なつき	那月	固有人名
かわはらはやと	川原颯斗	固有一般
かわはらひろむ	川原大夢	固有一般
かわはらづかたけし	河原塚毅	固有一般
たけし	毅	固有人名
かわばたかずや	河端和哉	固有一般
かわべしゅんたろう	河辺駿太郎	固有一般
しゅんたろう	駿太郎	固有人名
かわべはやお	川辺駿	固有一般
はやお	駿	固有人名
かわべゆうき	川邊裕紀	固有一般
ゆうき	裕紀	固有人名
かわまえはると	川前陽斗	固有一般
かわまえりきや	川前力也	固有一般
かわまたけんご	川又堅碁	固有一般
けんご	堅碁	固有人名
かわまたしんいちろう	川俣慎一郎	固有一般
しんいちろう	慎一郎	固有人名
かわまたゆうだい	川又由大	固有一般
ゆうだい	由大	固有人名
かわむらがくと	川村楽人	固有一般
がくと	楽人	固有人名
かわむらけいと	河村慶人	固有一般
けいと	慶人	固有人名
かわむらじゅんいち	川村淳一	固有一般
じゅんいち	淳一	固有人名
かわむらたかひろ	河村崇大	固有一般
たかひろ	崇大	固有人名
かわむらたくみ	河村匠	固有一般
かわむらたくむ	川村拓夢	固有一般
たくむ	拓夢	固有人名
かわむらはやと	河村颯人	固有一般
かわむらまいや	川村舞弥	固有一般
まいや	舞弥	固有人名
かわむらゆう	河村優	固有一般
かわむらるい	川村琉偉	固有一般
かわもとあきと	河本明人	固有一般
あきと	明人	固有人名
かわもとまさひで	川元正英	固有一般
まさひで	正英	固有人名
かわもとみつひろ	河本充弘	固有一般
みつひろ	充弘	固有人名
かわもとりょうじ	川本良二	固有一般
かわもとりよ	川本梨誉	固有一般
りよ	梨誉	固有人名
かわもりゆうま	川森有真	固有一般
ゆうま	有真	固有人名
かわらぎひびき	河原木響	固有一般
ひびき	響	固有人名
かわらじりょうた	河原地亮太	固有一般
かわらだゆう	川原田湧	固有一般
ゆう	湧	固有人名
かんかずのり	菅和範	固有一般
かずのり	和範	固有人名
かんそんほ	姜成浩	固有一般
そんほ	成浩	固有人名
かんひゅんす	姜鉉守	固有一般
ひゅんす	鉉守	固有人名
かんひょいる	姜曉一	固有一般
ひょいる	曉一	固有人名
かんざきだいすけ	神崎大輔	固有一般
かんざわあさい	虷沢旭飛	固有一般
あさい	旭飛	固有人名
かんだかつお	神田勝夫	固有一般
かつお	勝夫	固有人名
かんだしょうま	神田渉馬	固有一般
しょうま	渉馬	固有人名
かんだしょうや	神田翔哉	固有一般
しょうや	翔哉	固有人名
かんだふみゆき	神田文之	固有一般
ふみゆき	文之	固有人名
かんだゆめみ	神田夢実	固有一般
ゆめみ	夢実	固有人名
かんのこうき	菅野紘希	固有一般
こうき	紘希	固有人名
かんのしょうた	菅野将太	固有一般
かんのたけと	菅野翔斗	固有一般
たけと	翔斗	固有人名
かんのてつや	菅野哲也	固有一般
かんのまさあき	菅野将晃	固有一般
まさあき	将晃	固有人名
かんばやしごう	上林豪	固有一般
かんばやしたいせい	上林大誠	固有一般
かんべこうすけ	神戸康輔	固有一般
かんめらしゅうと	上米良柊人	固有一般
がなはかずき	我那覇和樹	固有一般
がやえいじ	賀谷英司	固有一般
えいじ	英司	固有人名
きかわだけんじ	黄川田賢司	固有一般
けんじ	賢司	固有人名
じゅふぇん	鞠楓	固有一般
ふぇん	楓	固有人名
きくいゆうすけ	菊井悠介	固有一般
きくおかたくろう	菊岡拓朗	固有一般
たくろう	拓朗	固有人名
きくがわはる	菊川晴	固有一般
きくたにあつし	菊谷篤資	固有一般
あつし	篤資	固有人名
きくちかん	菊池完	固有一般
かん	完	固有人名
きくちかんた	菊地貫太	固有一般
きくちきせき	菊池季汐	固有一般
きせき	季汐	固有人名
きくちけんた	菊地健太	固有一般
きくちこうすけ	菊地光将	固有一般
こうすけ	光将	固有人名
きくちしゅうた	菊地脩太	固有一般
しゅうた	脩太	固有人名
きくちしゅうた	菊池柊太	固有一般
しゅうた	柊太	固有人名
きくちしゅんすけ	菊地俊介	固有一般
きくちしょうた	菊池将太	固有一般
きくちしんきち	菊池新吉	固有一般
しんきち	新吉	固有人名
きくちたいち	菊地泰智	固有一般
たいち	泰智	固有人名
きくちだいすけ	菊池大介	固有一般
きくちとしみ	菊池利三	固有一般
としみ	利三	固有人名
きくちなおや	菊地直哉	固有一般
きくちりくと	菊池陸斗	固有一般
きくちりゅうほ	菊池流帆	固有一般
りゅうほ	流帆	固有人名
きくのたいき	菊野太紀	固有一般
たいき	太紀	固有人名
きくはらしろう	菊原志郎	固有一般
しろう	志郎	固有人名
きくもとゆうき	菊本侑希	固有一般
ゆうき	侑希	固有人名
きざわまさのり	木澤正徳	固有一般
まさのり	正徳	固有人名
きしかんた	岸寛大	固有一般
きしたかひで	紀氏隆秀	固有一般
たかひで	隆秀	固有人名
きしだかずひと	岸田和人	固有一般
かずひと	和人	固有人名
きしだしょうへい	岸田翔平	固有一般
きしだひろき	岸田裕樹	固有一般
ひろき	裕樹	固有人名
きしだゆうすけ	岸田悠佑	固有一般
ゆうすけ	悠佑	固有人名
きしもとたける	岸本武流	固有一般
たける	武流	固有人名
きしもとのぞむ	岸本望	固有一般
きじまかずき	鬼島和希	固有一般
きじまてつや	木島徹也	固有一般
きじまゆう	木島悠	固有一般
ゆう	悠	固有人名
きじまりょうすけ	木島良輔	固有一般
きたかずなり	喜多壱也	固有一般
かずなり	壱也	固有人名
きたかずま	北一真	固有一般
きたやすし	喜多靖	固有一般
やすし	靖	固有人名
きたりょうすけ	喜多涼介	固有一般
りょうすけ	涼介	固有人名
きたりょうま	北龍磨	固有一般
りょうま	龍磨	固有人名
きたいゆうき	北井佑季	固有一般
ゆうき	佑季	固有人名
きたうちこうせい	北内耕成	固有一般
こうせい	耕成	固有人名
きたおくれん	北奥蓮	固有一般
きたがわこうへい	北川滉平	固有一般
こうへい	滉平	固有人名
きたがわこうや	北川航也	固有一般
こうや	航也	固有人名
きたがわしゅうと	北川柊斗	固有一般
きたがわよしお	北川佳男	固有一般
よしお	佳男	固有人名
きたざとだいち	北里大地	固有一般
きたざわげんた	北澤元太	固有一般
きたざわつよし	北澤豪	固有一般
つよし	豪	固有人名
きたじまひであき	北嶋秀朗	固有一般
ひであき	秀朗	固有人名
きたじまゆうじ	北島祐二	固有一般
ゆうじ	祐二	固有人名
きたじまよしき	北島義生	固有一般
よしき	義生	固有人名
きたたにふみたか	北谷史孝	固有一般
ふみたか	史孝	固有人名
きたづめけんご	北爪健吾	固有一般
けんご	健吾	固有人名
きたでつとむ	北出勉	固有一般
つとむ	勉	固有人名
きたでなおひろ	北出尚大	固有一般
なおひろ	尚大	固有人名
きたにこうすけ	木谷公亮	固有一般
こうすけ	公亮	固有人名
きたのしょう	北野翔	固有一般
きたのそうた	北野颯太	固有一般
きたのたかゆき	北野貴之	固有一般
きたはしまさはる	北橋将治	固有一般
まさはる	将治	固有人名
きたはまりゅうせい	北浜琉星	固有一般
りゅうせい	琉星	固有人名
きたはらいつき	北原一樹	固有一般
いつき	一樹	固有人名
きたはらけんじ	北原健二	固有一般
きたはらたかひさ	北原毅之	固有一般
たかひさ	毅之	固有人名
きたはらだいすけ	北原大奨	固有一般
だいすけ	大奨	固有人名
きたむらかいちでぃ	北村海チディ	固有一般
きたむらくにお	北村邦夫	固有一般
くにお	邦夫	固有人名
きたむらたくや	北邑拓也	固有一般
きたむらともたか	北村知隆	固有一般
ともたか	知隆	固有人名
きたむらともや	北村知也	固有一般
ともや	知也	固有人名
きたむらふげつ	北村風月	固有一般
ふげつ	風月	固有人名
きたむらりゅうじ	北村隆二	固有一般
りゅうじ	隆二	固有人名
きたむらりょうた	北村椋太	固有一般
りょうた	椋太	固有人名
きたもとくにえ	北本久仁衛	固有一般
くにえ	久仁衛	固有人名
きたわきけんじ	北脇健慈	固有一般
けんじ	健慈	固有人名
きだたくや	喜田拓也	固有一般
きだひなた	喜田陽	固有一般
きだりょうが	貴田遼河	固有一般
りょうが	遼河	固有人名
きだりょうま	氣田亮真	固有一般
りょうま	亮真	固有人名
きちせひろし	吉瀬広志	固有一般
ひろし	広志	固有人名
きついたかひろ	木匠貴大	固有一般
きでゆうと	木出雄斗	固有一般
きでらこういち	木寺浩一	固有一般
こういち	浩一	固有人名
きとうりゅうと	紀藤隆翔	固有一般
りゅうと	隆翔	固有人名
きどこうき	木戸皓貴	固有一般
こうき	皓貴	固有人名
きどしゅうま	木戸柊摩	固有一般
しゅうま	柊摩	固有人名
きどくなおと	寄特直人	固有一般
きなてつひろ	喜名哲裕	固有一般
てつひろ	哲裕	固有人名
きのうちなお	木内直央	固有一般
なお	直央	固有人名
きのしたあさひ	木下太陽	固有一般
あさひ	太陽	固有人名
きのしたかいと	木下海斗	固有一般
きのしたこうすけ	木下康介	固有一般
きのしたしんのすけ	木下慎之輔	固有一般
しんのすけ	慎之輔	固有人名
きのしたたかあき	木下高彰	固有一般
たかあき	高彰	固有人名
きのしたてっせい	木下哲星	固有一般
てっせい	哲星	固有人名
きのしたはる	木下晴陽	固有一般
はる	晴陽	固有人名
きのしたまさき	木下正貴	固有一般
まさき	正貴	固有人名
きのしたゆう	木下悠	固有一般
きのしたよしあき	木下淑晶	固有一般
よしあき	淑晶	固有人名
きはらまさかず	木原正和	固有一般
まさかず	正和	固有人名
きはられい	木原励	固有一般
れい	励	固有人名
きばまさお	木場昌雄	固有一般
まさお	昌雄	固有人名
きふじけんた	木藤健太	固有一般
きべみらん	木部未嵐	固有一般
みらん	未嵐	固有人名
きむうぃまん	金位漫	固有一般
うぃまん	位漫	固有人名
きむえんじゅん	金殷中	固有一般
えんじゅん	殷中	固有人名
きむきす	金基洙	固有一般
きす	基洙	固有人名
きむくんほあん	金 根煥	固有一般
きむくゎんみん	金廣閔	固有一般
くゎんみん	廣閔	固有人名
きむげんちょる	金根哲	固有一般
げんちょる	根哲	固有人名
きむこんちょん	金功青	固有一般
こんちょん	功青	固有人名
きむさんう	金尚佑	固有一般
さんう	尚佑	固有人名
きむしんよん	金信泳	固有一般
しんよん	信泳	固有人名
きむじぇほ	金載桓	固有一般
じぇほ	載桓	固有人名
きむじょんう	金 正友	固有一般
きむじょんひゅん	金正賢	固有一般
じょんひゅん	正賢	固有人名
きむじょんぐん	金 鐘必	固有一般
きむじょんや	金正也	固有一般
じょんや	正也	固有人名
きむじんきゅ	金珍圭	固有一般
じんきゅ	珍圭	固有人名
きむじんす	金珍洙	固有一般
じんす	珍洙	固有人名
きむせうんよん	金 承龍	固有一般
きむそんぎ	金聖基	固有一般
そんぎ	聖基	固有人名
きむそんすん	金成純	固有一般
そんすん	成純	固有人名
きむそんみん	金誠敏	固有一般
そんみん	誠敏	固有人名
きむすんみん	金善珉	固有一般
すんみん	善珉	固有人名
きむせんよん	金成勇	固有一般
せんよん	成勇	固有人名
きむちよるほ	金 喆鎬	固有一般
きむでい	金大儀	固有一般
でい	大儀	固有人名
きむどほん	金度勲	固有一般
どほん	度勲	固有人名
きむどきゅん	金徒均	固有一般
どきゅん	徒均	固有人名
きむどけうん	金 都根	固有一般
きむどんぐぉん	金東權	固有一般
どんぐぉん	東權	固有人名
きむどんちゃん	金東燦	固有一般
どんちゃん	東燦	固有人名
きむどんひょん	金東炫	固有一般
どんひょん	東炫	固有人名
きむなむいる	金南一	固有一般
なむいる	南一	固有人名
きむひょんすん	金炫成	固有一般
ひょんすん	炫成	固有人名
きむひゅんしょん	金賢聖	固有一般
ひゅんしょん	賢聖	固有人名
きむほなむ	金浩男	固有一般
ほなむ	浩男	固有人名
きむほんよん	金弘淵	固有一般
ほんよん	弘淵	固有人名
きむみんう	金民友	固有一般
みんう	民友	固有人名
きむみんほ	金珉浩	固有一般
みんほ	珉浩	固有人名
きむみんきゅん	金民均	固有一般
みんきゅん	民均	固有人名
きむゆじん	金裕晋	固有一般
ゆじん	裕晋	固有人名
きむよんぎ	金永基	固有一般
よんぎ	永基	固有人名
きむよんぐぉん	金 英權	固有一般
きむよんくん	金 永根	固有一般
きむよんふぁん	金竜滉	固有一般
よんふぁん	竜滉	固有人名
きむらあつし	木村敦志	固有一般
あつし	敦志	固有人名
きむらかいと	木村魁人	固有一般
きむらかずし	木村和司	固有一般
きむらけいん	木村恵允	固有一般
けいん	恵允	固有人名
きむらごう	木村豪	固有一般
きむらしょうた	木村勝太	固有一般
しょうた	勝太	固有人名
きむらせいじ	木村誠二	固有一般
せいじ	誠二	固有人名
きむらせいめい	木村晟明	固有一般
せいめい	晟明	固有人名
きむらたかや	木村太哉	固有一般
たかや	太哉	固有人名
きむらたくと	木村卓斗	固有一般
たくと	卓斗	固有人名
きむらたつろう	木村龍朗	固有一般
たつろう	龍朗	固有人名
きむらてつまさ	木村哲昌	固有一般
てつまさ	哲昌	固有人名
きむらゆうき	木村裕貴	固有一般
きむらまこと	木村誠	固有一般
きむらまさひこ	木村允彦	固有一般
まさひこ	允彦	固有人名
きむらゆう	木村裕	固有一般
きむらゆうじ	木村祐志	固有一般
ゆうじ	祐志	固有人名
きむらゆうだい	木村勇大	固有一般
ゆうだい	勇大	固有人名
きむらりょうや	木村凌也	固有一般
きもつきひろと	肝付啓人	固有一般
きもとあおと	木本蒼翔	固有一般
あおと	蒼翔	固有人名
きもとけいすけ	木本敬介	固有一般
きもとたいが	木許太賀	固有一般
たいが	太賀	固有人名
きもとやすき	木本恭生	固有一般
やすき	恭生	固有人名
きやしだいすけ	樹森大介	固有一般
きやすこうせい	喜安康生	固有一般
こうせい	康生	固有人名
きやまこうへい	喜山康平	固有一般
きやまそうすけ	木山創資	固有一般
そうすけ	創資	固有人名
きやまたかゆき	木山隆之	固有一般
たかゆき	隆之	固有人名
きょうのゆうし	京野優士	固有一般
ゆうし	優士	固有人名
きょうやかずゆき	京谷和幸	固有一般
かずゆき	和幸	固有人名
きよかわさすが	清川流石	固有一般
さすが	流石	固有人名
きよかわはる	清川遥	固有一般
はる	遥	固有人名
きよたけこうき	清武功暉	固有一般
こうき	功暉	固有人名
きよたけひろし	清武弘嗣	固有一般
ひろし	弘嗣	固有人名
きよながたける	清永丈瑠	固有一般
たける	丈瑠	固有人名
きよのおとひこ	清野乙彦	固有一般
おとひこ	乙彦	固有人名
きよはらしょうへい	清原翔平	固有一般
きよもとたくみ	清本拓己	固有一般
きりそうた	桐蒼太	固有一般
そうた	蒼太	固有人名
きりきつかさ	桐木士	固有一般
つかさ	士	固有人名
きりはたかずしげ	桐畑和繁	固有一般
かずしげ	和繁	固有人名
きりやまりゅうと	桐山龍人	固有一般
りゅうと	龍人	固有人名
きろーらんこりん	キローラン木鈴	固有一般
こりん	木鈴	固有人名
きろーらんにある	キローラン菜入	固有一般
にある	菜入	固有人名
きわだただし	木和田匡	固有一般
ただし	匡	固有人名
きんてるまさ	金晃正	固有一般
てるまさ	晃正	固有人名
きむみょんひ	金明輝	固有一般
みょんひ	明輝	固有人名
きんりょうや	金亮哉	固有一般
りょうや	亮哉	固有人名
きんかわらいや	金川羅彌	固有一般
らいや	羅彌	固有人名
きんじょうあんどれたいき	金城アンドレ泰樹	固有一般
あんどれたいき	アンドレ泰樹	固有人名
きんじょうくりすとふぁーたつき	金城クリストファー達樹	固有一般
くりすとふぁーたつき	クリストファー達樹	固有人名
きんじょうじゃすてぃんしゅんき	金城ジャスティン俊樹	固有一般
じゃすてぃんしゅんき	ジャスティン俊樹	固有人名
ぎぼゆきひで	儀保幸英	固有一般
ゆきひで	幸英	固有人名
ぎまりくと	儀間陸斗	固有一般
ぎょうとくえい	行徳瑛	固有一般
えい	瑛	固有人名
くきたしんご	久木田紳吾	固有一般
しんご	紳吾	固有人名
くきのさとし	久木野聡	固有一般
さとし	聡	固有人名
くぎさきやすおみ	釘﨑康臣	固有一般
やすおみ	康臣	固有人名
くさかりけいた	草刈啓太	固有一般
くさかりなおだい	草苅脩大	固有一般
なおだい	脩大	固有人名
くさきかつひろ	草木克洋	固有一般
かつひろ	克洋	固有人名
くさずみこうのすけ	草住晃之介	固有一般
こうのすけ	晃之介	固有人名
くさのしゅうじ	草野修治	固有一般
しゅうじ	修治	固有人名
くさのまなと	草野真人	固有一般
まなと	真人	固有人名
くさのゆうき	草野侑己	固有一般
ゆうき	侑己	固有人名
くしだかずと	櫛田一斗	固有一般
かずと	一斗	固有人名
くしのりょう	櫛野亮	固有一般
くしびきかずき	櫛引一紀	固有一般
かずき	一紀	固有人名
くしびきまさとし	櫛引政敏	固有一般
まさとし	政敏	固有人名
くしびきみのる	櫛引実	固有一般
みのる	実	固有人名
くすかみじゅんぺい	楠神順平	固有一般
じゅんぺい	順平	固有人名
くすのきだいき	楠大樹	固有一般
くすのせあきひと	楠瀬章仁	固有一般
あきひと	章仁	固有人名
くすみけいし	楠美圭史	固有一般
けいし	圭史	固有人名
くすもとしゅうま	楠元秀真	固有一般
しゅうま	秀真	固有人名
くすもとたくみ	楠本卓海	固有一般
くすもとつばさ	楠本羽翼	固有一般
つばさ	羽翼	固有人名
くすもとゆきお	楠本幸雄	固有一般
ゆきお	幸雄	固有人名
くだかともお	久高友雄	固有一般
ともお	友雄	固有人名
くつかけゆうた	沓掛勇太	固有一般
ゆうた	勇太	固有人名
くつなきょうじ	忽那喬司	固有一般
きょうじ	喬司	固有人名
くどうあおい	工藤蒼生	固有一般
くどうきよかず	久藤清一	固有一般
きよかず	清一	固有人名
くどうこうた	工藤孝太	固有一般
くどうこうへい	工藤浩平	固有一般
こうへい	浩平	固有人名
くどうこうへい	工藤亘平	固有一般
こうへい	亘平	固有人名
くどうそうだい	工藤宗大	固有一般
そうだい	宗大	固有人名
くどうたいが	工藤大雅	固有一般
くどうまさと	工藤壮人	固有一般
まさと	壮人	固有人名
くどうまなと	工藤真人	固有一般
くどうみつてる	工藤光輝	固有一般
みつてる	光輝	固有人名
くどうゆうせい	工藤祐生	固有一般
ゆうせい	祐生	固有人名
くどうゆむ	工藤由夢	固有一般
ゆむ	由夢	固有人名
くどうりゅい	工藤瑠衣	固有一般
りゅい	瑠衣	固有人名
くにえだそら	國枝蒼空	固有一般
そら	蒼空	固有人名
くにたけゆうと	國武勇斗	固有一般
くにひろしゅうへい	國廣周平	固有一般
くにもとたかひろ	邦本宜裕	固有一般
たかひろ	宜裕	固有人名
くにもとれお	国本玲央	固有一般
くによしたかひろ	國吉貴博	固有一般
たかひろ	貴博	固有人名
くのじゅんや	久野純弥	固有一般
じゅんや	純弥	固有人名
くのともあき	久野智昭	固有一般
ともあき	智昭	固有人名
くのりせいあ	久乗聖亜	固有一般
せいあ	聖亜	固有人名
くばひかる	久場光	固有一般
くばまさとも	久場政朋	固有一般
まさとも	政朋	固有人名
くぼかいと	久保海都	固有一般
くぼせいいちろう	久保征一郎	固有一般
せいいちろう	征一郎	固有人名
くぼせいじ	久保政二	固有一般
せいじ	政二	固有人名
くぼたくみ	久保拓海	固有一般
くぼたけふさ	久保建英	固有一般
たけふさ	建英	固有人名
くぼたつひこ	久保竜彦	固有一般
たつひこ	竜彦	固有人名
くぼつばさ	久保飛翔	固有一般
つばさ	飛翔	固有人名
くぼとうじろう	久保藤次郎	固有一般
とうじろう	藤次郎	固有人名
くぼゆういち	久保裕一	固有一般
ゆういち	裕一	固有人名
くぼゆうや	久保裕也	固有一般
ゆうや	裕也	固有人名
くぼりき	久保力輝	固有一般
りき	力輝	固有人名
くぼりくと	久保吏久斗	固有一般
りくと	吏久斗	固有人名
くぼしまたけはる	久保島健晴	固有一般
たけはる	健晴	固有人名
くぼたあきら	久保田陽	固有一般
あきら	陽	固有人名
くぼたかずね	久保田和音	固有一般
かずね	和音	固有人名
くぼたまなぶ	久保田学	固有一般
くぼたりゅうじ	窪田龍二	固有一般
りゅうじ	龍二	固有人名
くぼたりょう	窪田稜	固有一般
くぼたりょう	窪田良	固有一般
りょう	良	固有人名
くぼたりんた	久保田琳太	固有一般
りんた	琳太	固有人名
くぼにわりょうた	久保庭良太	固有一般
くぼやまよしきよ	久保山由清	固有一般
よしきよ	由清	固有人名
くまがいあんどりゅー	熊谷アンドリュー	固有一般
あんどりゅー	アンドリュー	固有人名
くまがいけいや	熊谷奎哉	固有一般
けいや	奎哉	固有人名
くまがいこうき	熊谷昂暉	固有一般
こうき	昂暉	固有人名
くまがいこうじ	熊谷浩二	固有一般
こうじ	浩二	固有人名
くまがいしゅうじ	熊谷柊治	固有一般
しゅうじ	柊治	固有人名
くまがいしゅん	熊谷駿	固有一般
くまがいたつや	熊谷達也	固有一般
くまがいまさひこ	熊谷雅彦	固有一般
くまがわかける	熊川翔	固有一般
くまくらたくみ	熊倉匠	固有一般
くまくらなるき	熊倉成希	固有一般
くまさかこうき	熊坂光希	固有一般
くますわかずき	熊澤和希	固有一般
くますわけいすけ	熊澤圭祐	固有一般
くまたなおき	熊田直紀	固有一般
なおき	直紀	固有人名
くまばやししんご	熊林親吾	固有一般
しんご	親吾	固有人名
くまもとゆうた	熊本雄太	固有一般
くめこうたろう	久米航太郎	固有一般
くめだせいあ	久米田聖海	固有一般
せいあ	聖海	固有人名
くもんひろあき	公文裕明	固有一般
ひろあき	裕明	固有人名
くらおとむ	倉尾都夢	固有一般
とむ	都夢	固有人名
くらかずひろと	倉員宏人	固有一般
ひろと	宏人	固有人名
くらかわようへい	藏川洋平	固有一般
くらたこうへい	蔵田岬平	固有一般
こうへい	岬平	固有人名
くらたしげき	藏田茂樹	固有一般
しげき	茂樹	固有人名
くらたしゅう	倉田秋	固有一般
しゅう	秋	固有人名
くらたじゅら	倉田楠楽	固有一般
じゅら	楠楽	固有人名
くらぬきかずき	倉貫一毅	固有一般
かずき	一毅	固有人名
くらぬきらう	倉貫嵐羽	固有一般
らう	嵐羽	固有人名
くらみつとしき	蔵光利紀	固有一般
としき	利紀	固有人名
くらもとたかし	倉本崇史	固有一般
たかし	崇史	固有人名
くりさわりょういち	栗澤僚一	固有一般
りょういち	僚一	固有人名
くりしたこはる	栗下心暖明	固有一般
こはる	心暖明	固有人名
くりしまけんた	栗島健太	固有一般
くりたしおん	栗田詩音	固有一般
くりたたいじろう	栗田泰次郎	固有一般
たいじろう	泰次郎	固有人名
くりたまーくあじぇい	栗田マークアジェイ	固有一般
まーくあじぇい	マークアジェイ	固有人名
くりはらかつし	栗原克志	固有一般
かつし	克志	固有人名
くりはらけいすけ	栗原圭介	固有一般
けいすけ	圭介	固有人名
くりはらしゅうすけ	栗原秀輔	固有一般
しゅうすけ	秀輔	固有人名
くりはらもとやす	栗原元康	固有一般
もとやす	元康	固有人名
くりはらゆうぞう	栗原勇蔵	固有一般
ゆうぞう	勇蔵	固有人名
くりはらいぶらひむじゅにあ	栗原イブラヒムジュニア	固有一般
くりもとひろき	栗本広輝	固有一般
ひろき	広輝	固有人名
くりやまなおき	栗山直樹	固有一般
くりやまゆうき	栗山裕貴	固有一般
くりわきたくと	栗脇拓人	固有一般
たくと	拓人	固有人名
くるまやしんたろう	車屋紳太郎	固有一般
しんたろう	紳太郎	固有人名
くろいしたかや	黒石貴哉	固有一般
くろうじけいすけ	黒氏啓介	固有一般
けいすけ	啓介	固有人名
くろかわあつし	黒川淳史	固有一般
あつし	淳史	固有人名
くろかわけいすけ	黒川圭介	固有一般
くろかわたかや	黒河貴矢	固有一般
たかや	貴矢	固有人名
くろかわらいへい	黒川雷平	固有一般
らいへい	雷平	固有人名
くろききょうへい	黒木恭平	固有一般
くろきけんご	黒木謙吾	固有一般
けんご	謙吾	固有人名
くろきこうけん	黒木晃賢	固有一般
こうけん	晃賢	固有人名
くろきこうへい	黒木晃平	固有一般
くろぎまさと	黒木聖仁	固有一般
まさと	聖仁	固有人名
くろさきはやと	黒﨑隼人	固有一般
くろさきひさし	黒崎 久志	固有一般
くろせじゅんや	黒瀬純哉	固有一般
じゅんや	純哉	固有人名
くろせともき	黒瀬朋希	固有一般
ともき	朋希	固有人名
くろせりひと	黒瀬理仁	固有一般
りひと	理仁	固有人名
くろだかいせい	黒田開生	固有一般
かいせい	開生	固有人名
くろだたくま	黒田拓真	固有一般
くろつまさる	黒津勝	固有一般
くろのたかと	黒野崇人	固有一般
たかと	崇人	固有人名
くろべてるあき	黒部光昭	固有一般
てるあき	光昭	固有人名
くろみやわたる	黒宮渉	固有一般
くわさきゆうや	鍬先祐弥	固有一般
ゆうや	祐弥	固有人名
くわじまりょうた	桑島良汰	固有一般
りょうた	良汰	固有人名
くわたかずま	鍬田一雅	固有一般
かずま	一雅	固有人名
くわたたいせい	桒田大誠	固有一般
くわだしんいちろう	桒田慎一朗	固有一般
しんいちろう	慎一朗	固有人名
くわづるたつき	桑鶴樹	固有一般
たつき	樹	固有人名
くわはらかいと	桑原海人	固有一般
かいと	海人	固有人名
くわはらそうた	桑原颯太	固有一般
くわはらたけし	桑原剛	固有一般
くわはらりくと	桒原陸人	固有一般
くわばらこうた	桑原晃大	固有一般
こうた	晃大	固有人名
くわばらひろよし	桑原裕義	固有一般
ひろよし	裕義	固有人名
くわもとゆうじ	桑本ユウジ	固有一般
ゆうじ	ユウジ	固有人名
ぐんじけんたろう	郡司健太朗	固有一般
けんたろう	健太朗	固有人名
けいごしゆうじ	慶越雄二	固有一般
けんもつたくむ	監物拓歩	固有一般
たくむ	拓歩	固有人名
げんかんた	玄哉太	固有一般
かんた	哉太	固有人名
げんしんてつ	玄新哲	固有一般
しんてつ	新哲	固有人名
げんかちょうた	源河朝太	固有一般
ちょうた	朝太	固有人名
げんだあゆむ	現田歩夢	固有一般
げんぺいやまと	源平倭人	固有一般
やまと	倭人	固有人名
こじゅんい	高准翼	固有一般
じゅんい	准翼	固有人名
こじょんうん	高正云	固有一般
じょんうん	正云	固有人名
こじょんす	高宗秀	固有一般
じょんす	宗秀	固有人名
こいけじゅんき	小池純輝	固有一般
こいけだいき	小池大喜	固有一般
こいけともき	小池知己	固有一般
ともき	知己	固有人名
こいけゆうき	小池悠貴	固有一般
こいけゆうた	小池裕太	固有一般
ゆうた	裕太	固有人名
こいけりゅうた	小池龍太	固有一般
りゅうた	龍太	固有人名
こいけりょうへい	小池良平	固有一般
りょうへい	良平	固有人名
こいしたつおみ	小石龍臣	固有一般
たつおみ	龍臣	固有人名
こいしてつや	小石哲也	固有一般
こいずみけい	小泉慶	固有一般
こいずみけいじ	小泉圭二	固有一般
けいじ	圭二	固有人名
こいずみさとし	小泉訓	固有一般
さとし	訓	固有人名
こいずみじゅんじ	小泉淳嗣	固有一般
じゅんじ	淳嗣	固有人名
こいずみせいや	小泉靖弥	固有一般
せいや	靖弥	固有人名
こいずみゆうと	小泉勇人	固有一般
ゆうと	勇人	固有人名
こいずみよしお	小泉佳穂	固有一般
よしお	佳穂	固有人名
こいでしょうた	小井手翔太	固有一般
こいでゆうた	小出悠太	固有一般
こいどまさあき	小井土正亮	固有一般
まさあき	正亮	固有人名
こきょんて	髙 慶汰	固有一般
こせうんじん	高昇辰	固有一般
こうたかひろ	高宇洋	固有一般
たかひろ	宇洋	固有人名
こうきゆうしん	幸喜祐心	固有一般
ゆうしん	祐心	固有人名
こうだひでまさ	甲田英將	固有一般
ひでまさ	英將	固有人名
こうだまさかず	幸田将和	固有一般
まさかず	将和	固有人名
こうづきしょうせい	上月翔聖	固有一般
しょうせい	翔聖	固有人名
こうづきそういちろう	上月壮一郎	固有一般
そういちろう	壮一郎	固有人名
こうのあゆむ	河野歩夢	固有一般
こうのしゅうと	幸野志有人	固有一般
しゅうと	志有人	固有人名
こうのじゅんいち	高野純一	固有一般
じゅんいち	純一	固有人名
こうのじゅんご	河野淳吾	固有一般
じゅんご	淳吾	固有人名
こうまりょうた	高麗稜太	固有一般
こうもとひろゆき	河本裕之	固有一般
ひろゆき	裕之	固有人名
こおろきしんぞう	興梠慎三	固有一般
しんぞう	慎三	固有人名
こえづかかずあき	肥塚一晃	固有一般
かずあき	一晃	固有人名
こうりひろむ	郡大夢	固有一般
こがかずなり	古賀一成	固有一般
こがけいたろう	古賀鯨太朗	固有一般
けいたろう	鯨太朗	固有人名
こがさとし	古賀聡	固有一般
こがしゅんたろう	古賀俊太郎	固有一般
しゅんたろう	俊太郎	固有人名
こがせいじ	古賀誠史	固有一般
せいじ	誠史	固有人名
こがたいよう	古賀太陽	固有一般
こがたかひろ	古賀貴大	固有一般
こがたくま	古賀琢磨	固有一般
たくま	琢磨	固有人名
こがまさと	古賀正人	固有一般
こがまさひろ	古賀正紘	固有一般
まさひろ	正紘	固有人名
こくばこじろう	國場虎次朗	固有一般
こじろう	虎次朗	固有人名
こくぶしんたろう	國分伸太郎	固有一般
こくぶりゅうじ	國分龍司	固有一般
りゅうじ	龍司	固有人名
こくぶんまさし	國分将	固有一般
まさし	将	固有人名
こくぼじゅん	小久保純	固有一般
こくぼれおぶらいあん	小久保玲央ブライアン	固有一般
こくりょういっぺい	國領 一平	固有一般
こくりょうゆうと	國領雄斗	固有一般
こぐれだいき	小暮大器	固有一般
だいき	大器	固有人名
こぐれふみや	木暮郁哉	固有一般
こけぐちたくや	苔口卓也	固有一般
たくや	卓也	固有人名
こさいりょうた	小齋崚太	固有一般
りょうた	崚太	固有人名
こさかあきのり	小阪昭典	固有一般
あきのり	昭典	固有人名
こざかいあらた	小酒井新大	固有一般
あらた	新大	固有人名
こざわりゅうき	小澤竜己	固有一般
りゅうき	竜己	固有人名
こしだふた	越田颯太	固有一般
ふた	颯太	固有人名
こしみちそうた	越道草太	固有一般
そうた	草太	固有人名
こしもとゆうた	越元佑太	固有一般
こじまけいたつ	小島圭巽	固有一般
けいたつ	圭巽	固有人名
こじまけんしょう	小嶋健聖	固有一般
けんしょう	健聖	固有人名
こじましゅうた	小島秀太	固有一般
こじましゅうと	小島秀仁	固有一般
しゅうと	秀仁	固有人名
こじまたくし	小島卓	固有一般
たくし	卓	固有人名
こじまのぶゆき	小島伸幸	固有一般
のぶゆき	伸幸	固有人名
こじまひろみ	小島宏美	固有一般
ひろみ	宏美	固有人名
こじまひろみ	小島弘已	固有一般
ひろみ	弘已	固有人名
こじままさと	小島幹敏	固有一般
まさと	幹敏	固有人名
こじままさや	小島雅也	固有一般
こじまみつあき	小島光顕	固有一般
みつあき	光顕	固有人名
こじまりょうすけ	小島亨介	固有一般
りょうすけ	亨介	固有人名
こじまりんしろう	小島凛士郎	固有一般
りんしろう	凛士郎	固有人名
こすがそうし	小菅颯士	固有一般
そうし	颯士	固有人名
こすきこうた	小漉康太	固有一般
こすぎけいた	小杉啓太	固有一般
こすぎとしゆき	小杉敏之	固有一般
こすぎはるや	小杉晴也	固有一般
はるや	晴也	固有人名
こだけしょん	小竹知恩	固有一般
しょん	知恩	固有人名
こたにけんご	小谷健悟	固有一般
けんご	健悟	固有人名
こたにひろき	小谷光毅	固有一般
ひろき	光毅	固有人名
こたにゆうき	小谷祐喜	固有一般
ゆうき	祐喜	固有人名
こだまあらた	児玉新	固有一般
こだましゅんと	児玉駿斗	固有一般
しゅんと	駿斗	固有人名
こだまじゅん	児玉潤	固有一般
こだまつよし	児玉剛	固有一般
こだまれおと	兒玉澪王斗	固有一般
れおと	澪王斗	固有人名
こづかかずき	小塚和季	固有一般
かずき	和季	固有人名
こてがわこうき	小手川宏基	固有一般
こうき	宏基	固有人名
こてつゆうたろう	小鉄雄太郎	固有一般
ゆうたろう	雄太郎	固有人名
こてらかずき	小寺一生	固有一般
こてらゆうき	小寺優輝	固有一般
ゆうき	優輝	固有人名
こながやちひろ	古長谷千博	固有一般
ちひろ	千博	固有人名
こにしひなた	小西陽向	固有一般
ひなた	陽向	固有人名
こにしゆうだい	小西雄大	固有一般
こにしりょうま	小西龍馬	固有一般
りょうま	龍馬	固有人名
このゆうと	古野優斗	固有一般
このしまらい	此島頼勇	固有一般
らい	頼勇	固有人名
こはつたつき	古波津辰希	固有一般
たつき	辰希	固有人名
こはらのぼる	小原昇	固有一般
のぼる	昇	固有人名
こばかいと	木場海斗	固有一般
こばひぬた	木塲暖太	固有一般
ひぬた	暖太	固有人名
こばしじょう	小橋丈	固有一般
こばやしいわな	小林岩魚	固有一般
いわな	岩魚	固有人名
こばやしかいと	小林海翔	固有一般
かいと	海翔	固有人名
こばやしかいや	小林海也	固有一般
かいや	海也	固有人名
こばやしかずや	小林和矢	固有一般
かずや	和矢	固有人名
こばやしかん	小林幹	固有一般
かん	幹	固有人名
こばやしけいた	小林慶太	固有一般
こばやしさとる	小林悟	固有一般
こばやししょうた	古林将太	固有一般
こばやししょうま	小林章馬	固有一般
しょうま	章馬	固有人名
こばやしじゅん	小林洵	固有一般
こばやしせいごう	小林成豪	固有一般
せいごう	成豪	固有人名
こばやしそういちろう	小林壮一郎	固有一般
こばやしたいよう	小林太陽	固有一般
こばやしたかみち	小林高道	固有一般
たかみち	高道	固有人名
こばやしたくみ	小林巧弥	固有一般
たくみ	巧弥	固有人名
こばやしたつき	小林竜樹	固有一般
たつき	竜樹	固有人名
こばやしだいご	小林大悟	固有一般
こばやしだいち	小林大智	固有一般
だいち	大智	固有人名
こばやしてるあき	小林久晃	固有一般
てるあき	久晃	固有人名
こばやしともみつ	小林智光	固有一般
ともみつ	智光	固有人名
こばやしなつき	小林夏生	固有一般
なつき	夏生	固有人名
こばやしひでまさ	小林秀征	固有一般
ひでまさ	秀征	固有人名
こばやしひろき	小林弘記	固有一般
ひろき	弘記	固有人名
こばやしひろと	小林洸翔	固有一般
ひろと	洸翔	固有人名
こばやしひろゆき	小林宏之	固有一般
ひろゆき	宏之	固有人名
こばやしまお	小林真鷹	固有一般
まお	真鷹	固有人名
こばやしまこと	小林誠	固有一般
こばやしまさたか	小林将天	固有一般
まさたか	将天	固有人名
こばやしまさみつ	小林成光	固有一般
まさみつ	成光	固有人名
こばやしみのる	小林稔	固有一般
みのる	稔	固有人名
こばやしやすたか	小林康剛	固有一般
やすたか	康剛	固有人名
こばやしゆう	小林悠	固有一般
こばやしゆうき	小林祐希	固有一般
こばやしゆき	小林友希	固有一般
ゆき	友希	固有人名
こばやしゆうき	小林裕紀	固有一般
こばやしゆうき	小林優希	固有一般
こばやしゆうすけ	小林祐介	固有一般
ゆうすけ	祐介	固有人名
こばやしゆうぞう	小林祐三	固有一般
こばやしゆうた	小林祐太	固有一般
ゆうた	祐太	固有人名
こばやしようすけ	小林陽介	固有一般
こばやしよしゆき	小林慶行	固有一般
よしゆき	慶行	固有人名
こばやしりく	小林里駆	固有一般
りく	里駆	固有人名
こばやしりく	小林陸玖	固有一般
りく	陸玖	固有人名
こばやしりょう	小林亮	固有一般
こばやしりょうた	小林亮太	固有一般
こばらしょうご	小原章吾	固有一般
しょうご	章吾	固有人名
こばりきよみつ	小針清允	固有一般
きよみつ	清允	固有人名
こぶきしょうた	木吹翔太	固有一般
こぼりそら	小堀空	固有一般
こまいゆきひろ	駒井幸弘	固有一般
ゆきひろ	幸弘	固有人名
こまいよしあき	駒井善成	固有一般
よしあき	善成	固有人名
こまきまさのぶ	小牧成亘	固有一般
まさのぶ	成亘	固有人名
こまたけんじ	古俣健次	固有一般
こまつけんた	小松憲太	固有一般
こまつしゅんだい	小松隼大	固有一般
しゅんだい	隼大	固有人名
こまつたくみ	小松拓幹	固有一般
たくみ	拓幹	固有人名
こまつはやた	小松駿太	固有一般
はやた	駿太	固有人名
こまつゆうと	小松雄音	固有一般
ゆうと	雄音	固有人名
こまつるい	小松塁	固有一般
こまつれん	小松蓮	固有一般
こまつざきたもつ	小松崎保	固有一般
たもつ	保	固有人名
こまつばらまなぶ	小松原学	固有一般
こまのゆういち	駒野友一	固有一般
ゆういち	友一	固有人名
こみようた	小見洋太	固有一般
ようた	洋太	固有人名
こみねたかゆき	小峯隆幸	固有一般
こみねたくや	小峯拓也	固有一般
こみやまさき	小宮真輝	固有一般
こみやまたかのぶ	小宮山尊信	固有一般
たかのぶ	尊信	固有人名
こむたようすけ	小牟田洋佑	固有一般
ようすけ	洋佑	固有人名
こもりひいろ	小森飛絢	固有一般
ひいろ	飛絢	固有人名
こもりだともあき	小森田友明	固有一般
こやただし	小屋禎	固有一般
ただし	禎	固有人名
こやけたかと	小宅空大	固有一般
たかと	空大	固有人名
こやなぎたつし	小柳達司	固有一般
たつし	達司	固有人名
こやのけんじ	小谷野顕治	固有一般
けんじ	顕治	固有人名
こやまあきら	小山彬	固有一般
あきら	彬	固有人名
こやまあらた	小山新	固有一般
こやまけんじ	小山健二	固有一般
こやましゅり	小山珠里	固有一般
しゅり	珠里	固有人名
こやましょうや	小山聖也	固有一般
しょうや	聖也	固有人名
こやまじょうい	小山丈偉	固有一般
じょうい	丈偉	固有人名
こやまたくと	小山拓土	固有一般
たくと	拓土	固有人名
こやまたくや	小山拓哉	固有一般
たくや	拓哉	固有人名
こやままお	小山真生	固有一般
まお	真生	固有人名
こやまつともや	小屋松知哉	固有一般
ともや	知哉	固有人名
これだしんご	是枝真伍	固有一般
しんご	真伍	固有人名
こんどういっせい	近藤壱成	固有一般
いっせい	壱成	固有人名
こんどうかんた	近藤貫太	固有一般
こんどうがくとく	近藤岳登	固有一般
がくとく	岳登	固有人名
こんどうくらば	近藤蔵波	固有一般
くらば	蔵波	固有人名
こんどうこうじ	今藤幸治	固有一般
こうじ	幸治	固有人名
こんどうしゅうご	近藤嵩悟	固有一般
しゅうご	嵩悟	固有人名
こんどうしんご	近藤慎吾	固有一般
しんご	慎吾	固有人名
こんどうたかし	近藤貴司	固有一般
たかし	貴司	固有人名
こんどうたかとら	近藤高虎	固有一般
たかとら	高虎	固有人名
こんどうてつし	近藤徹志	固有一般
てつし	徹志	固有人名
こんどうともき	近藤友喜	固有一般
こんどうなおや	近藤直也	固有一般
なおや	直也	固有人名
こんどうやまと	近藤大和	固有一般
こんどうゆうすけ	近藤祐介	固有一般
こんどうよしひと	近藤慶一	固有一般
よしひと	慶一	固有人名
こんどうりくと	近藤陸翔	固有一般
りくと	陸翔	固有人名
こんのあきら	今野章	固有一般
こんのいぶき	今野息吹	固有一般
いぶき	息吹	固有人名
こんのかずや	紺野和也	固有一般
こんのかつひろ	近野勝大	固有一般
かつひろ	勝大	固有人名
こんのそういちろう	今野聡一郎	固有一般
そういちろう	聡一郎	固有人名
こんのたいすけ	今野太祐	固有一般
たいすけ	太祐	固有人名
こんのひろや	今野滉也	固有一般
ひろや	滉也	固有人名
こんのやすゆき	今野泰幸	固有一般
やすゆき	泰幸	固有人名
こんのゆむ	今野勇夢	固有一般
ゆむ	勇夢	固有人名
ごだいむ	呉大陸	固有一般
だいむ	大陸	固有人名
ごうたつや	郷達哉	固有一般
ごうけゆうた	郷家友太	固有一般
ごうしひろかず	郷司弘和	固有一般
ひろかず	弘和	固有人名
ごうだこうき	合田光希	固有一般
ごきゅうしょう	御給匠	固有一般
しょう	匠	固有人名
ごとうきょうすけ	後藤京介	固有一般
きょうすけ	京介	固有人名
ごとうけいすけ	後藤啓介	固有一般
ごとうけいた	後藤圭太	固有一般
ごとうけいた	後藤啓太	固有一般
ごとうこうすけ	後藤虹介	固有一般
こうすけ	虹介	固有人名
ごとうじゅんじ	後藤純二	固有一般
じゅんじ	純二	固有人名
ごとうたくま	後藤卓磨	固有一般
たくま	卓磨	固有人名
ごとうたろう	後藤太郎	固有一般
ごとうだいき	後藤大輝	固有一般
ごとうなおき	後東尚輝	固有一般
ごとうひびき	後藤響	固有一般
ごとうまさあき	後藤雅明	固有一般
まさあき	雅明	固有人名
ごとうゆうじ	後藤裕司	固有一般
ごとうゆうすけ	後藤佑介	固有一般
ゆうすけ	佑介	固有人名
ごとうゆうすけ	後藤優介	固有一般
ごとうゆうへい	後藤雄平	固有一般
ごとうゆうや	後藤佑也	固有一般
ゆうや	佑也	固有人名
ごとうよしかず	後藤義一	固有一般
よしかず	義一	固有人名
ごとうりょう	後藤涼	固有一般
ごとうわたる	後藤亘	固有一般
わたる	亘	固有人名
ごとうだこうき	後藤田亘輝	固有一般
こうき	亘輝	固有人名
ごみいくと	五味郁登	固有一般
いくと	郁登	固有人名
ごやひろと	呉屋大翔	固有一般
ごりょうじゅんき	五領淳樹	固有一般
じゅんき	淳樹	固有人名
ごんだしゅういち	権田修一	固有一般
ごんどうゆうすけ	権東勇介	固有一般
さいかわゆうすけ	斉川雄介	固有一般
ゆうすけ	雄介	固有人名
さいきかずと	斉木和人	固有一般
さいじょうきょうや	西城響也	固有一般
きょうや	響也	固有人名
さいとうかずき	齋藤和希	固有一般
さいとうかずき	齊藤和樹	固有一般
さいとうかつゆき	斎藤克幸	固有一般
かつゆき	克幸	固有人名
さいとうかんた	齊藤貫太	固有一般
さいとうきよし	斉藤紀由	固有一般
きよし	紀由	固有人名
さいとうけいた	齋藤恵太	固有一般
けいた	恵太	固有人名
さいとうけいと	斎藤恵人	固有一般
さいとうけんじろう	齋藤謙二郎	固有一般
けんじろう	謙二郎	固有人名
さいとうこうき	斉藤光毅	固有一般
こうき	光毅	固有人名
さいとうこうすけ	齋藤功佑	固有一般
こうすけ	功佑	固有人名
さいとうこうすけ	齋藤滉介	固有一般
こうすけ	滉介	固有人名
さいとうこうた	斎藤宏太	固有一般
こうた	宏太	固有人名
さいとうこうや	斎藤広野	固有一般
こうや	広野	固有人名
さいとうしょうた	齋藤翔太	固有一般
さいとうしょうた	斎藤翔太	固有一般
さいとうじゅんぺい	斎藤純平	固有一般
さいとうせいいち	斉藤誠一	固有一般
さいとうせな	齊藤聖七	固有一般
せな	聖七	固有人名
さいとうそうた	斎藤聡太	固有一般
そうた	聡太	固有人名
さいとうたかし	齋藤恭志	固有一般
たかし	恭志	固有人名
さいとうたけし	斉藤武志	固有一般
たけし	武志	固有人名
さいとうだいき	齊藤大輝	固有一般
さいとうだいじゅ	斎藤大珠	固有一般
だいじゅ	大珠	固有人名
さいとうだいすけ	斉藤大介	固有一般
さいとうだいすけ	斎藤大輔	固有一般
さいとうとしひで	斉藤俊秀	固有一般
としひで	俊秀	固有人名
さいとうひろし	斉藤浩史	固有一般
さいとうまさき	齋藤将基	固有一般
さいとうまさと	斉藤雅人	固有一般
さいとうまさや	斎藤雅也	固有一般
さいとうまなぶ	齋藤学	固有一般
さいとうみつき	齊藤未月	固有一般
みつき	未月	固有人名
さいとうゆうま	斉藤勇真	固有一般
ゆうま	勇真	固有人名
さいとうゆずき	斉藤柚樹	固有一般
ゆずき	柚樹	固有人名
さいとうようすけ	斎藤陽介	固有一般
さいとうようた	齊藤洋大	固有一般
ようた	洋大	固有人名
さいとうよのすけ	齋藤耀之介	固有一般
よのすけ	耀之介	固有人名
さいとうよしと	齊藤慈斗	固有一般
よしと	慈斗	固有人名
さいとうりゅう	齋藤竜	固有一般
さいとうりゅうじ	才藤龍治	固有一般
さいとうりゅうせい	齊藤隆成	固有一般
りゅうせい	隆成	固有人名
さいとうりょう	斉藤諒	固有一般
さいとうりょう	齋藤遼	固有一般
りょう	遼	固有人名
さえきけいた	佐伯啓太	固有一般
さえきしんのすけ	佐伯清之助	固有一般
しんのすけ	清之助	固有人名
さえきなおや	佐伯直哉	固有一般
さえきりゅうせい	佐伯竜征	固有一般
りゅうせい	竜征	固有人名
さえきれん	佐伯蓮	固有一般
さかけいすけ	坂圭祐	固有一般
さかいけんたろう	栄井健太郎	固有一般
さかいごうそん	酒井高聖	固有一般
ごうそん	高聖	固有人名
さかいごとう	酒井高徳	固有一般
ごとう	高徳	固有人名
さかいしゅいち	酒井崇一	固有一般
しゅいち	崇一	固有人名
さかいしゅんや	坂井駿也	固有一般
しゅんや	駿也	固有人名
さかいしょうご	坂井将吾	固有一般
さかいたかまさ	酒井貴政	固有一般
たかまさ	貴政	固有人名
さかいたくみ	酒井匠	固有一般
さかいたつま	酒井達磨	固有一般
たつま	達磨	固有人名
さかいたつや	坂井達弥	固有一般
さかいだいすけ	坂井大将	固有一般
だいすけ	大将	固有人名
さかいとしき	堺俊暉	固有一般
としき	俊暉	固有人名
さかいともゆき	酒井友之	固有一般
ともゆき	友之	固有人名
さかいなおき	酒井直樹	固有一般
さかいのりよし	酒井宣福	固有一般
のりよし	宣福	固有人名
さかいはるか	阪井暖	固有一般
はるか	暖	固有人名
さかいひろき	酒井宏樹	固有一般
さかいひろし	坂井浩	固有一般
ひろし	浩	固有人名
さかいひろと	酒井大登	固有一般
ひろと	大登	固有人名
さかいまさき	酒井将輝	固有一般
さかいゆうき	酒井湧暉	固有一般
ゆうき	湧暉	固有人名
さかいようじ	堺陽二	固有一般
ようじ	陽二	固有人名
さかいようへい	坂井洋平	固有一般
さかいりゅうすけ	酒井隆介	固有一般
さかいりょう	酒井良	固有一般
さかいやけいすけ	堺屋佳介	固有一般
けいすけ	佳介	固有人名
さかきしょうた	榊翔太	固有一般
さかきばらきょうた	榊原杏太	固有一般
きょうた	杏太	固有人名
さかきばらけいご	榊原彗悟	固有一般
けいご	彗悟	固有人名
さかくらゆうじ	阪倉裕二	固有一般
さかぐちけんじ	坂口健司	固有一般
さかぐちしょうい	坂口祥尉	固有一般
しょうい	祥尉	固有人名
さかぐちそうた	阪口颯汰	固有一般
そうた	颯汰	固有人名
さかたあきひろ	阪田章裕	固有一般
あきひろ	章裕	固有人名
さかただいき	坂田大樹	固有一般
さかただいすけ	坂田大輔	固有一般
さかたりょうた	坂田良太	固有一般
さかたれいや	阪田澪哉	固有一般
れいや	澪哉	固有人名
さかのとよふみ	阪野豊史	固有一般
とよふみ	豊史	固有人名
さかもといおり	坂元一渚璃	固有一般
いおり	一渚璃	固有人名
さかもといさ	坂本一彩	固有一般
いさ	一彩	固有人名
さかもとかける	坂本翔	固有一般
さかもとかずと	阪本一仁	固有一般
かずと	一仁	固有人名
さかもとかんた	坂本勘汰	固有一般
かんた	勘汰	固有人名
さかもときりや	坂本稀吏也	固有一般
きりや	稀吏也	固有人名
さかもとけい	坂本敬	固有一般
さかもとけいすけ	坂本圭佑	固有一般
けいすけ	圭佑	固有人名
さかもとこうき	坂本亘基	固有一般
こうき	亘基	固有人名
さかもとこうじ	坂本紘司	固有一般
こうじ	紘司	固有人名
さかもとこだい	坂本広大	固有一般
こだい	広大	固有人名
さかもとしゅうすけ	坂本修佑	固有一般
しゅうすけ	修佑	固有人名
さかもとしょういちろう	阪本翔一朗	固有一般
しょういちろう	翔一朗	固有人名
さかもとじゅんぺい	坂本順平	固有一般
さかもとたけひさ	坂本武久	固有一般
たけひさ	武久	固有人名
さかもとたつひろ	坂元達裕	固有一般
たつひろ	達裕	固有人名
さかもとだいき	坂元大希	固有一般
だいき	大希	固有人名
さかもとひろゆき	坂本寛之	固有一般
ひろゆき	寛之	固有人名
さかもとまさき	阪本将基	固有一般
さかもとまさたか	坂本將貴	固有一般
まさたか	將貴	固有人名
さかもとようすけ	坂元要介	固有一般
ようすけ	要介	固有人名
さかもとよしゆき	坂本義行	固有一般
よしゆき	義行	固有人名
さかもとるい	坂本琉維	固有一般
るい	琉維	固有人名
さかもとれい	坂本玲	固有一般
れい	玲	固有人名
さがいっぺい	佐賀一平	固有一般
いっぺい	一平	固有人名
さがりく	嵯峨理久	固有一般
りく	理久	固有人名
さがらりゅうのすけ	相良竜之介	固有一般
さがわこうすけ	佐川洸介	固有一般
こうすけ	洸介	固有人名
さがわりょうすけ	佐川亮介	固有一般
さきむらゆうすけ	崎村祐丞	固有一般
ゆうすけ	祐丞	固有人名
さきもとしんすけ	嵜本晋輔	固有一般
しんすけ	晋輔	固有人名
さくたりゅうたろう	作田龍太郎	固有一般
りゅうたろう	龍太郎	固有人名
さくだゆうじ	作田裕次	固有一般
ゆうじ	裕次	固有人名
さくはらしょう	作原翔	固有一般
さくまたいち	佐久間太一	固有一般
さくまはねと	佐久間翔士	固有一般
はねと	翔士	固有人名
さくまりょう	佐久間遼	固有一般
さくらいしげる	桜井繁	固有一般
しげる	繁	固有人名
さくらいしょうご	桜井鐘吾	固有一般
しょうご	鐘吾	固有人名
さくらいたかし	桜井孝司	固有一般
たかし	孝司	固有人名
さくらいたつのり	櫻井辰徳	固有一般
たつのり	辰徳	固有人名
さくらいなおと	桜井直人	固有一般
さくらいふうが	櫻井風我	固有一般
ふうが	風我	固有人名
さくらいまさと	桜井正人	固有一般
さくらうちなぎさ	櫻内渚	固有一般
なぎさ	渚	固有人名
さくらがわそろもん	櫻川ソロモン	固有一般
そろもん	ソロモン	固有人名
さくらぎりょうた	桜木亮太	固有一般
さくらだかずき	櫻田和樹	固有一般
さくらだりょうが	桜田凌雅	固有一般
りょうが	凌雅	固有人名
さくらばりき	櫻庭立樹	固有一般
りき	立樹	固有人名
さけもとのりゆき	酒本憲幸	固有一般
のりゆき	憲幸	固有人名
さこあらた	佐古創	固有一般
あらた	創	固有人名
さこたいち	迫大智	固有一般
さこまあや	佐古真礼	固有一般
まあや	真礼	固有人名
さこいしんや	迫井深也	固有一般
しんや	深也	固有人名
さこりくと	酒向陸斗	固有一般
ささあゆむ	笹歩睦	固有一般
あゆむ	歩睦	固有人名
ささがきたくや	笹垣拓也	固有一般
ささがきりょうすけ	笹垣亮介	固有一般
ささきあさひ	佐々木旭	固有一般
ささきいっき	佐々木一輝	固有一般
ささきかい	佐々木快	固有一般
ささきけいた	佐々木啓太	固有一般
ささきしょう	佐々木翔	固有一般
ささきしょうご	佐々木翔悟	固有一般
しょうご	翔悟	固有人名
ささきそうた	佐々木奏太	固有一般
そうた	奏太	固有人名
ささきそうたろう	佐々木想太郎	固有一般
そうたろう	想太郎	固有人名
ささきたいじゅ	佐々木大樹	固有一般
たいじゅ	大樹	固有人名
ささきたかひろ	佐々木崇浩	固有一般
たかひろ	崇浩	固有人名
ささきたかや	佐々木貴哉	固有一般
ささきたくみ	佐々木匠	固有一般
ささきただし	佐々木善	固有一般
ただし	善	固有人名
ささきだいき	佐々木大貴	固有一般
ささきだいじゅ	佐々木大樹	固有一般
だいじゅ	大樹	固有人名
ささきつばさ	佐々木翼	固有一般
ささきはやと	佐々木勇人	固有一般
ささきひとし	佐々木仁	固有一般
ひとし	仁	固有人名
ささきひろかず	佐々木博和	固有一般
ささきひろき	佐々木宏樹	固有一般
ささきまさと	佐々木雅人	固有一般
ささきまさと	佐々木雅士	固有一般
まさと	雅士	固有人名
ささきまさなお	佐々木雅尚	固有一般
まさなお	雅尚	固有人名
ささきゆうすけ	佐々木勇輔	固有一般
ゆうすけ	勇輔	固有人名
ささきゆうた	佐々木祐太	固有一般
ささきゆうり	佐々木優吏	固有一般
ゆうり	優吏	固有人名
ささきようじ	佐々木陽次	固有一般
ようじ	陽次	固有人名
ささきりくお	佐々木陸生	固有一般
りくお	陸生	固有人名
ささきりゅうた	佐々木竜太	固有一般
りゅうた	竜太	固有人名
ささきわたる	佐々木渉	固有一般
ささはらけんしん	笹原堅信	固有一般
けんしん	堅信	固有人名
ささはらしゅうへい	笹原脩平	固有一般
しゅうへい	脩平	固有人名
ささはらのぶひで	笹原伸秀	固有一般
のぶひで	伸秀	固有人名
ささはらよしみ	笹原義巳	固有一般
よしみ	義巳	固有人名
ささやまりのん	笹山琉暢	固有一般
りのん	琉暢	固有人名
さしなみゆうと	差波優人	固有一般
ゆうと	優人	固有人名
さそうかずあき	佐相壱明	固有一般
かずあき	壱明	固有人名
さたひでや	佐多秀哉	固有一般
ひでや	秀哉	固有人名
さだそたろう	佐田聡太郎	固有一般
そたろう	聡太郎	固有人名
さだとみのぶひろ	貞富信宏	固有一般
のぶひろ	信宏	固有人名
さだもとけいき	定本佳樹	固有一般
けいき	佳樹	固有人名
さつかわあつき	薩川淳貴	固有一般
あつき	淳貴	固有人名
さつかわのりひろ	薩川了洋	固有一般
のりひろ	了洋	固有人名
さつきだせいや	五月田星矢	固有一般
せいや	星矢	固有人名
さつかようすけ	佐塚洋介	固有一般
さとうあおい	佐藤碧	固有一般
あおい	碧	固有人名
さとうあきひろ	佐藤昭大	固有一般
あきひろ	昭大	固有人名
さとうあきひろ	佐藤晃大	固有一般
あきひろ	晃大	固有人名
さとうあさひ	佐藤旭	固有一般
さとうえいじ	佐藤英二	固有一般
えいじ	英二	固有人名
さとうおおみ	佐藤大実	固有一般
おおみ	大実	固有人名
さとうかいと	佐藤海斗	固有一般
さとうかずき	佐藤一樹	固有一般
さとうかずき	佐藤和樹	固有一般
さとうかずと	佐藤和斗	固有一般
かずと	和斗	固有人名
さとうかずひろ	佐藤和弘	固有一般
かずひろ	和弘	固有人名
さとうかんた	佐藤勘太	固有一般
さとうかんた	佐藤幹太	固有一般
さとうきょう	佐藤響	固有一般
きょう	響	固有人名
さとうけいすけ	佐藤恵介	固有一般
さとうけんすけ	佐藤謙介	固有一般
けんすけ	謙介	固有人名
さとうけんたろう	佐藤健太郎	固有一般
さとうこういち	佐藤洸一	固有一般
こういち	洸一	固有人名
さとうこうき	佐藤幸生	固有一般
こうき	幸生	固有人名
さとうこうだい	佐藤幸大	固有一般
こうだい	幸大	固有人名
さとうこうよう	佐藤昂洋	固有一般
こうよう	昂洋	固有人名
さとうさとし	佐藤聡	固有一般
さとうしゅん	佐藤隼	固有一般
さとうしょう	佐藤祥	固有一般
さとうしょうきち	佐藤昌吉	固有一般
しょうきち	昌吉	固有人名
さとうしんいち	佐藤真一	固有一般
さとうしんや	佐藤真也	固有一般
さとうじゅん	佐藤潤	固有一般
さとうじゅんき	佐藤遵樹	固有一般
じゅんき	遵樹	固有人名
さとうじゅんじ	佐藤淳志	固有一般
じゅんじ	淳志	固有人名
さとうじょうせい	佐藤丈晟	固有一般
じょうせい	丈晟	固有人名
さとうじん	佐藤尽	固有一般
じん	尽	固有人名
さとうすばる	佐藤昴	固有一般
すばる	昴	固有人名
さとうそうた	佐藤颯汰	固有一般
さとうそうま	佐藤颯真	固有一般
さとうたいが	佐藤大雅	固有一般
さとうたいすけ	佐藤太亮	固有一般
たいすけ	太亮	固有人名
さとうたいせい	佐藤大晴	固有一般
さとうたいち	佐藤太一	固有一般
さとうたいてん	佐藤大典	固有一般
たいてん	大典	固有人名
さとうだい	佐藤大	固有一般
さとうだいき	佐藤大基	固有一般
だいき	大基	固有人名
さとうだいき	佐藤大樹	固有一般
さとうつよし	佐藤健	固有一般
つよし	健	固有人名
さとうとしや	佐藤俊哉	固有一般
さとうなおき	佐藤尚輝	固有一般
さとうはやと	佐藤颯人	固有一般
さとうはると	佐藤遥翔	固有一般
はると	遥翔	固有人名
さとうひろひこ	佐藤陽彦	固有一般
ひろひこ	陽彦	固有人名
さとうひさき	佐藤尚生	固有一般
ひさき	尚生	固有人名
さとうひさと	佐藤寿人	固有一般
ひさと	寿人	固有人名
さとうひさや	佐藤久弥	固有一般
ひさや	久弥	固有人名
さとうひろし	佐藤浩	固有一般
さとうひろと	佐藤大翔	固有一般
さとうまさみ	佐藤正美	固有一般
まさみ	正美	固有人名
さとうまさや	佐藤将也	固有一般
まさや	将也	固有人名
さとうみくや	佐藤未来也	固有一般
みくや	未来也	固有人名
さとうみのる	佐藤穣	固有一般
みのる	穣	固有人名
さとうみひろ	佐藤海宏	固有一般
みひろ	海宏	固有人名
さとうみゆ	佐藤未勇	固有一般
みゆ	未勇	固有人名
さとうやすゆき	佐藤康之	固有一般
やすゆき	康之	固有人名
さとうゆうあん	佐藤悠安	固有一般
ゆうあん	悠安	固有人名
さとうゆいと	佐藤唯斗	固有一般
ゆいと	唯斗	固有人名
さとうゆうき	佐藤悠希	固有一般
ゆうき	悠希	固有人名
さとうゆうし	佐藤有志	固有一般
ゆうし	有志	固有人名
さとうゆうすけ	佐藤悠介	固有一般
さとうゆうせい	佐藤勇盛	固有一般
ゆうせい	勇盛	固有人名
さとうゆうた	佐藤祐太	固有一般
さとうゆうた	佐藤勇大	固有一般
ゆうた	勇大	固有人名
さとうゆうと	佐藤勇人	固有一般
さとうゆうへい	佐藤優平	固有一般
さとうゆうや	佐藤優也	固有一般
ゆうや	優也	固有人名
さとうゆきひこ	佐藤由紀彦	固有一般
ゆきひこ	由紀彦	固有人名
さとうようせい	佐藤陽成	固有一般
ようせい	陽成	固有人名
さとうようた	佐藤瑶大	固有一般
ようた	瑶大	固有人名
さとうようへい	佐藤洋平	固有一般
さとうよしあき	佐藤慶明	固有一般
よしあき	慶明	固有人名
さとうよしき	佐藤喜生	固有一般
よしき	喜生	固有人名
さとうりき	佐藤璃樹	固有一般
りき	璃樹	固有人名
さとうりくと	佐藤陸人	固有一般
さとうりゅうせい	佐藤瑠星	固有一般
りゅうせい	瑠星	固有人名
さとうりゅうのすけ	佐藤龍之介	固有一般
さとうりょう	佐藤亮	固有一般
さとうりょう	佐藤諒	固有一般
さとうりょうが	佐藤凌我	固有一般
りょうが	凌我	固有人名
さとうれいすけ	佐藤伶介	固有一般
れいすけ	伶介	固有人名
さとおかりゅうと	里岡龍人	固有一般
さとみひとよし	里見仁義	固有一般
ひとよし	仁義	固有人名
さとみりゅうたろう	里見龍太郎	固有一般
さとりかいと	左部開斗	固有一般
かいと	開斗	固有人名
さなだこうた	真田幸太	固有一般
こうた	幸太	固有人名
さなだまさのり	真田雅則	固有一般
まさのり	雅則	固有人名
さねとゆき	實藤友紀	固有一般
ゆき	友紀	固有人名
さねのぶのりあき	実信憲明	固有一般
のりあき	憲明	固有人名
さねよしのりただ	實好礼忠	固有一般
のりただ	礼忠	固有人名
さのかいしゅう	佐野海舟	固有一般
かいしゅう	海舟	固有人名
さのこうだい	佐野航大	固有一般
こうだい	航大	固有人名
さのつばさ	佐野翼	固有一般
さのともあき	佐野友昭	固有一般
ともあき	友昭	固有人名
さのゆうや	佐野裕哉	固有一般
さのりくと	佐野陸人	固有一般
さのりくほ	佐野陸歩	固有一般
りくほ	陸歩	固有人名
さはしとうま	佐橋杜真	固有一般
とうま	杜真	固有人名
さはらひでき	佐原秀樹	固有一般
さほこうへい	佐保昂兵衛	固有一般
こうへい	昂兵衛	固有人名
さめしまああと	鮫島亜々斗	固有一般
ああと	亜々斗	固有人名
さめしまこうた	鮫島晃太	固有一般
さららりつき	皿良立輝	固有一般
りつき	立輝	固有人名
さるたはるき	猿田遥己	固有一般
はるき	遥己	固有人名
さるたひろのり	猿田浩得	固有一般
ひろのり	浩得	固有人名
さわまさかつ	澤昌克	固有一般
まさかつ	昌克	固有人名
さわいなおと	澤井直人	固有一般
さわいりしげお	沢入重雄	固有一般
しげお	重雄	固有人名
さわかみりゅうじ	澤上竜二	固有一般
さわぐちまさひこ	澤口雅彦	固有一般
さわざきりょうた	澤崎凌大	固有一般
りょうた	凌大	固有人名
さわしまあきら	澤島輝	固有一般
さわだあつき	澤田篤樹	固有一般
あつき	篤樹	固有人名
さわだかずき	澤田和樹	固有一般
さわだけんた	澤田健太	固有一般
さわだけんたろう	沢田謙太郎	固有一般
けんたろう	謙太郎	固有人名
さわだこう	澤田恒	固有一般
こう	恒	固有人名
さわだしょう	澤田将	固有一般
しょう	将	固有人名
さわだしょうご	澤田章吾	固有一般
さわだたかし	澤田崇	固有一般
さわだひろゆき	澤田博行	固有一般
さわのぼりまさあき	澤登正朗	固有一般
まさあき	正朗	固有人名
さんだなおき	三田尚希	固有一般
さんだんばたあつき	三反畑篤樹	固有一般
さんとすあでみーる	三渡洲アデミール	固有一般
あでみーる	アデミール	固有人名
さんとすあれさんどろ	三都主 アレサンドロ	固有一般
さんとすまいと	三渡洲舞人	固有一般
まいと	舞人	固有人名
さんぼんすげたかし	三本菅崇	固有一般
ざいぜんけいいち	財前恵一	固有一般
けいいち	恵一	固有人名
ざいぜんのぶゆき	財前宣之	固有一般
のぶゆき	宣之	固有人名
ざいつしゅんいちろう	財津俊一郎	固有一般
しゅんいちろう	俊一郎	固有人名
しいなかずま	椎名一馬	固有一般
かずま	一馬	固有人名
しいなのぶゆき	椎名伸志	固有一般
のぶゆき	伸志	固有人名
しいはしけいや	椎橋慧也	固有一般
けいや	慧也	固有人名
しいはらたくや	椎原拓也	固有一般
しおかわたけと	塩川岳人	固有一般
たけと	岳人	固有人名
しおざきしょう	塩﨑彰	固有一般
しょう	彰	固有人名
しおざわしょうご	塩沢勝吾	固有一般
しょうご	勝吾	固有人名
しおざわたつや	塩沢達也	固有一般
しおたひとし	塩田仁史	固有一般
ひとし	仁史	固有人名
しおたにしんすけ	塩谷伸介	固有一般
しんすけ	伸介	固有人名
しおたにつかさ	塩谷司	固有一般
しおのそら	塩野空	固有一般
しおはまりょう	塩浜遼	固有一般
しかのしゅうへい	鹿野修平	固有一般
しかのふうた	鹿野楓太	固有一般
ふうた	楓太	固有人名
しかまゆうき	色摩雄貴	固有一般
ゆうき	雄貴	固有人名
しかやまたくま	鹿山拓真	固有一般
しがきじえい	紫垣慈瑛	固有一般
じえい	慈瑛	固有人名
しきだたかよし	式田高義	固有一般
たかよし	高義	固有人名
しきだゆい	敷田唯	固有一般
ゆい	唯	固有人名
しげたいら	茂平	固有一般
しげさだそう	繁定蒼	固有一般
そう	蒼	固有人名
しげたゆきのり	重田征紀	固有一般
ゆきのり	征紀	固有人名
しげはらたけひと	茂原岳人	固有一般
たけひと	岳人	固有人名
しげひろたくや	重廣卓也	固有一般
しげまつけんたろう	重松健太郎	固有一般
しげみまさと	重見柾斗	固有一般
まさと	柾斗	固有人名
しげみつたかあき	重光貴葵	固有一般
たかあき	貴葵	固有人名
しだいずほ	志田出帆	固有一般
いずほ	出帆	固有人名
しちたかあき	志知孝明	固有一般
しながわだいき	品川大輝	固有一般
しなだたろう	品田太郎	固有一般
しなだまなと	品田愛斗	固有一般
まなと	愛斗	固有人名
しのざきしょうき	篠崎清輝	固有一般
しょうき	清輝	固有人名
しのざきてるかず	篠崎輝和	固有一般
てるかず	輝和	固有人名
しのだよしのり	篠田善之	固有一般
よしのり	善之	固有人名
しのはらこうじろう	篠原弘次郎	固有一般
こうじろう	弘次郎	固有人名
しのはらともや	篠原友哉	固有一般
しのはらひろひと	篠原宏仁	固有一般
ひろひと	宏仁	固有人名
しのはらゆうだい	篠原佑岳	固有一般
ゆうだい	佑岳	固有人名
しのみやゆうせい	四宮悠成	固有一般
ゆうせい	悠成	固有人名
しのもりらい	篠森羅唯	固有一般
らい	羅唯	固有人名
しばけいた	柴圭汰	固有一般
けいた	圭汰	固有人名
しばのぶひろ	柴暢彦	固有一般
のぶひろ	暢彦	固有人名
しばこやゆういち	柴小屋雄一	固有一般
しばさきかいと	柴﨑海翔	固有一般
しばさきがく	柴崎岳	固有一般
しばさきこうせい	柴﨑 晃誠	固有一般
しばさきたかひろ	柴崎貴広	固有一般
しばざきくにひろ	柴崎邦博	固有一般
くにひろ	邦博	固有人名
しばたこうじろう	柴田航次郎	固有一般
こうじろう	航次郎	固有人名
しばたしょう	芝田将	固有一般
しばたしんご	柴田慎吾	固有一般
しばたそうすけ	柴田壮介	固有一般
そうすけ	壮介	固有人名
しばただいち	柴田大地	固有一般
しばたとおる	柴田徹	固有一般
しばたりゅうたろう	柴田隆太朗	固有一般
りゅうたろう	隆太朗	固有人名
しばとかい	柴戸海	固有一般
かい	海	固有人名
しばはらまこと	柴原誠	固有一般
しばむらなおや	柴村直弥	固有一般
なおや	直弥	固有人名
しばもとれん	芝本蓮	固有一般
しばやままさや	柴山昌也	固有一般
まさや	昌也	固有人名
しぶやつばさ	渋谷飛翔	固有一般
しぶやまさや	澁谷雅也	固有一般
しぶやりょう	渋谷亮	固有一般
しまたくし	島卓視	固有一般
たくし	卓視	固有人名
しまおかけんた	島岡健太	固有一般
しまかわとしお	島川俊郎	固有一般
としお	俊郎	固有人名
しまがきしょう	島垣翔	固有一般
しまさきゆう	島嵜佑	固有一般
ゆう	佑	固有人名
しまざききょうへい	島崎恭平	固有一般
しまざきはじめ	島崎元	固有一般
はじめ	元	固有人名
しまづとらし	島津虎史	固有一般
とらし	虎史	固有人名
しまだしゅうすけ	島田周輔	固有一般
しゅうすけ	周輔	固有人名
しまだしょうご	嶋田正吾	固有一般
しまだしんたろう	嶋田慎太郎	固有一般
しまだたかひろ	島田貴裕	固有一般
たかひろ	貴裕	固有人名
しまだたくみ	島田拓海	固有一般
しまだはると	島田春人	固有一般
はると	春人	固有人名
しまだゆうき	島田祐輝	固有一般
ゆうき	祐輝	固有人名
しまだゆうすけ	島田裕介	固有一般
しまだゆずる	島田譲	固有一般
ゆずる	譲	固有人名
しまづゆあん	嶋津柚杏	固有一般
ゆあん	柚杏	固有人名
しまづらいせい	島津頼盛	固有一般
らいせい	頼盛	固有人名
しまぬきじゅん	島貫純	固有一般
しまぶくろしんすけ	島袋信介	固有一般
しんすけ	信介	固有人名
しまむらたくや	島村拓弥	固有一般
しまむらつよし	島村毅	固有一般
つよし	毅	固有人名
しまむらまさし	島村征志	固有一般
まさし	征志	固有人名
しまむられいの	島村麗乃	固有一般
れいの	麗乃	固有人名
しまややつのり	島屋八徳	固有一般
やつのり	八徳	固有人名
しみずあつき	清水敦貴	固有一般
あつき	敦貴	固有人名
しみずかずお	清水和男	固有一般
しみずかずまさ	清水和昌	固有一般
かずまさ	和昌	固有人名
しみずかずまさ	清水一雅	固有一般
かずまさ	一雅	固有人名
しみずけいき	清水慶記	固有一般
けいき	慶記	固有人名
しみずけいすけ	清水圭介	固有一般
しみずけんた	清水健太	固有一般
しみずこうへい	清水航平	固有一般
しみずこうや	清水康也	固有一般
こうや	康也	固有人名
しみずしんたろう	清水慎太郎	固有一般
しみずじゅん	清水純	固有一般
しみずせいりゅう	清水星竜	固有一般
せいりゅう	星竜	固有人名
しみずたいち	清水太一	固有一般
しみずたかふみ	清水貴文	固有一般
しみずたけし	清水武士	固有一般
たけし	武士	固有人名
しみずつばさ	清水大翔	固有一般
つばさ	大翔	固有人名
しみずのりひさ	清水範久	固有一般
のりひさ	範久	固有人名
しみずはるき	清水春樹	固有一般
しみずひかる	清水光	固有一般
しみずひらい	清水飛来	固有一般
ひらい	飛来	固有人名
しみずまなと	清水愛都	固有一般
まなと	愛都	固有人名
しみずゆうと	清水悠斗	固有一般
しみずようすけ	清水陽介	固有一般
しみずらい	清水羅偉	固有一般
らい	羅偉	固有人名
しみずりょうま	清水綾馬	固有一般
りょうま	綾馬	固有人名
しむらこう	志村滉	固有一般
しむらしゅんた	志村駿太	固有一般
しむらのぼる	志村謄	固有一般
のぼる	謄	固有人名
しむらひろき	志村弘樹	固有一般
しもかわけんいち	下川健一	固有一般
しもかわせいご	下川誠吾	固有一般
せいご	誠吾	固有人名
しもかわたいよう	下川太陽	固有一般
しもかわてつや	下川哲矢	固有一般
てつや	哲矢	固有人名
しもかわはるき	下川陽輝	固有一般
はるき	陽輝	固有人名
しもかわまさと	下川雅人	固有一般
しもかわようた	下川陽太	固有一般
しもがみしょうた	下上昇大	固有一般
しょうた	昇大	固有人名
しもぐちわかば	下口稚葉	固有一般
わかば	稚葉	固有人名
しもさかこうき	下坂晃城	固有一般
こうき	晃城	固有人名
しもざわゆうた	下澤悠太	固有一般
しもしりゅうじ	下司隆士	固有一般
りゅうじ	隆士	固有人名
しもじしょう	下地奨	固有一般
しもたいらたかひろ	下平隆宏	固有一般
たかひろ	隆宏	固有人名
しもだこうへい	下田光平	固有一般
こうへい	光平	固有人名
しもだたかし	下田崇	固有一般
しもだほくと	下田北斗	固有一般
ほくと	北斗	固有人名
しもだよしひろ	下田栄祐	固有一般
よしひろ	栄祐	固有人名
しもどうりゅうせい	下堂竜聖	固有一般
りゅうせい	竜聖	固有人名
しもなかりょうが	下中凌我	固有一般
しもはたしょうご	下畠翔吾	固有一般
しもはらりく	下原凌空	固有一般
りく	凌空	固有人名
しもひらたくみ	下平匠	固有一般
しもむらとみ	下村東美	固有一般
とみ	東美	固有人名
しもむらゆうた	下村悠太	固有一般
しゅうゆいち	周余冶	固有一般
ゆいち	余冶	固有人名
しゅぎょうともひと	修行智仁	固有一般
ともひと	智仁	固有人名
しゅとうこうた	首藤光翼	固有一般
こうた	光翼	固有人名
しゅないだーじゅんのすけ	シュナイダー潤之介	固有一般
じゅんのすけ	潤之介	固有人名
しょうじけいたろう	庄司啓太郎	固有一般
しょうじげん	昌子源	固有一般
げん	源	固有人名
しょうじそらのすけ	庄司宙ノ介	固有一般
そらのすけ	宙ノ介	固有人名
しょうじたいち	東海林泰地	固有一般
たいち	泰地	固有人名
しょうじたかし	庄司孝	固有一般
たかし	孝	固有人名
しょうじほのや	庄司朋乃也	固有一般
ほのや	朋乃也	固有人名
しょうじよしひろ	庄司悦大	固有一般
よしひろ	悦大	固有人名
しょうないこうた	庄内航汰	固有一般
こうた	航汰	固有人名
しょうむらともき	正村友希	固有一般
しらいあつし	白井淳	固有一般
しらいえいじ	白井永地	固有一般
えいじ	永地	固有人名
しらいこうすけ	白井康介	固有一般
しらいしゅうへい	白井脩平	固有一般
しらいたくと	白井卓翔	固有一般
たくと	卓翔	固有人名
しらいたつや	白井達也	固有一般
しらいはるき	白井陽貴	固有一般
はるき	陽貴	固有人名
しらいはると	白井陽斗	固有一般
しらいひろゆき	白井博幸	固有一般
ひろゆき	博幸	固有人名
しらいゆうと	白井裕人	固有一般
ゆうと	裕人	固有人名
しらいりょうすけ	白井亮丞	固有一般
りょうすけ	亮丞	固有人名
しらいしけん	白石健	固有一般
しらいしともゆき	白石智之	固有一般
しらおひでひと	白尾秀人	固有一般
ひでひと	秀人	固有人名
しらおかてぃもしぃ	白岡ティモシィ	固有一般
てぃもしぃ	ティモシィ	固有人名
しらがなおき	白神端基	固有一般
なおき	端基	固有人名
しらさかふうま	白坂楓馬	固有一般
ふうま	楓馬	固有人名
しらさきりょうへい	白崎凌兵	固有一般
りょうへい	凌兵	固有人名
しらすけんと	白須健斗	固有一般
しらたにけんと	白谷建人	固有一般
しらとだいき	白土大貴	固有一般
しらとりゆうと	白鳥悠仁	固有一般
ゆうと	悠仁	固有人名
しらはまそうじろう	白濱聡二郎	固有一般
そうじろう	聡二郎	固有人名
しろたあつし	代田敦資	固有一般
あつし	敦資	固有人名
しろみずこうた	城水晃太	固有一般
しろわはやて	城和隼颯	固有一般
はやて	隼颯	固有人名
しんこうへい	進昂平	固有一般
こうへい	昂平	固有人名
しんちぼん	申在範	固有一般
ちぼん	在範	固有人名
しんびょんほ	申秉皓	固有一般
びょんほ	秉皓	固有人名
しんゆうたろう	新裕太朗	固有一般
ゆうたろう	裕太朗	固有人名
しんりょうすけ	新良介	固有一般
りょうすけ	良介	固有人名
しんぎょうじかずひこ	眞行寺和彦	固有一般
かずひこ	和彦	固有人名
しんざとしょうへい	新里彰平	固有一般
しょうへい	彰平	固有人名
しんざとりょう	新里亮	固有一般
しんざわだいち	新澤大知	固有一般
しんじょうはるき	新城暖基	固有一般
はるき	暖基	固有人名
しんじょうひろき	新條宏喜	固有一般
ひろき	宏喜	固有人名
しんじょうまなと	新城愛斗	固有一般
しんちゅうつよし	新中剛史	固有一般
つよし	剛史	固有人名
しんとうかつよし	信藤 健仁	固有一般
しんどうせいじ	進藤誠司	固有一般
せいじ	誠司	固有人名
しんどうりょうすけ	進藤亮佑	固有一般
りょうすけ	亮佑	固有人名
しんぼかいり	新保海鈴	固有一般
かいり	海鈴	固有人名
しんみょうまさひろ	新明正広	固有一般
まさひろ	正広	固有人名
しんみょうりゅうた	新明龍太	固有一般
しんむらじゅんぺい	新村純平	固有一般
じとうぞのまさや	地頭薗雅弥	固有一般
まさや	雅弥	固有人名
じぬしぞのひでみ	地主園秀美	固有一般
ひでみ	秀美	固有人名
じゃーめいんりょう	ジャーメイン良	固有一般
じょしょうひ	徐暁飛	固有一般
しょうひ	暁飛	固有人名
じょうしょうじ	城彰二	固有一般
しょうじ	彰二	固有人名
じょうごひさし	城後寿	固有一般
ひさし	寿	固有人名
じょうじょうかんた	城定幹大	固有一般
かんた	幹大	固有人名
じょうじょうしんじ	城定信次	固有一般
しんじ	信次	固有人名
じょうにししゅんだい	上西駿大	固有一般
しゅんだい	駿大	固有人名
じょうもりやすたか	城森康誉	固有一般
やすたか	康誉	固有人名
ちょんじんほ	鄭震浩	固有一般
じんほ	震浩	固有人名
じょんとうほ	丁 東浩	固有一般
じんのたくや	神野卓哉	固有一般
すえおかりゅうじ	末岡龍二	固有一般
すえきひろや	末木裕也	固有一般
すえつぐあつき	末次敦貴	固有一般
すえつぐしょうご	末次章悟	固有一般
しょうご	章悟	固有人名
すえつぐはやて	末次颯	固有一般
すえながとうあ	末永透瑛	固有一般
とうあ	透瑛	固有人名
すえよしとしや	末吉隼也	固有一般
としや	隼也	固有人名
すえよしるい	末吉塁	固有一般
すがだいき	菅大輝	固有一般
すがいたくや	菅井拓也	固有一般
すがいなおき	菅井直樹	固有一般
すがいひでひろ	須貝英大	固有一般
ひでひろ	英大	固有人名
すがじまひろき	菅嶋弘希	固有一般
ひろき	弘希	固有人名
すがたまさひろ	菅田真啓	固有一般
まさひろ	真啓	固有人名
すがぬまかずあき	菅沼一晃	固有一般
すがぬましゅんや	菅沼駿哉	固有一般
しゅんや	駿哉	固有人名
すがぬまみのる	菅沼実	固有一般
すがのけんいち	菅野賢一	固有一般
すがのたくま	菅野拓真	固有一般
すがのはる	菅野波琉	固有一般
はる	波琉	固有人名
すがのりゅうせい	菅野隆星	固有一般
りゅうせい	隆星	固有人名
すがはらたろう	菅原太郎	固有一般
すがもとがく	菅本岳	固有一般
すがやしゅうと	菅谷脩人	固有一般
しゅうと	脩人	固有人名
すがわらこうた	菅原康太	固有一般
すがわらしゅうと	菅原脩斗	固有一般
しゅうと	脩斗	固有人名
すがわらしんり	菅原心里	固有一般
しんり	心里	固有人名
すがわらたいき	菅原大幹	固有一般
たいき	大幹	固有人名
すがわらとも	菅原智	固有一般
とも	智	固有人名
すがわらひろみち	菅原大道	固有一般
ひろみち	大道	固有人名
すがわらゆきなり	菅原由勢	固有一般
ゆきなり	由勢	固有人名
すがわらりゅうのすけ	菅原龍之助	固有一般
りゅうのすけ	龍之助	固有人名
すきがらまさひろ	鋤柄昌宏	固有一般
すぎいはやて	杉井颯	固有一般
すぎうらきょうへい	杉浦恭平	固有一般
すぎうらしゅんご	杉浦駿吾	固有一般
しゅんご	駿吾	固有人名
すぎうらふみや	杉浦文哉	固有一般
すぎうらりきと	杉浦力斗	固有一般
りきと	力斗	固有人名
すぎおかだいき	杉岡大暉	固有一般
だいき	大暉	固有人名
すぎさきこうすけ	杉﨑皐輔	固有一般
こうすけ	皐輔	固有人名
すぎたはやと	杉田隼	固有一般
はやと	隼	固有人名
すぎたまさひこ	杉田真彦	固有一般
まさひこ	真彦	固有人名
すぎたまさひろ	杉田将宏	固有一般
まさひろ	将宏	固有人名
すぎのけんと	杉野健斗	固有一般
すぎのしんたろう	杉野伸太朗	固有一般
しんたろう	伸太朗	固有人名
すぎのたいちろう	杉野太一朗	固有一般
たいちろう	太一朗	固有人名
すぎむらしゅんすけ	杉村駿介	固有一般
すぎもとけい	杉本圭	固有一般
すぎもとけいた	杉本恵太	固有一般
すぎもとけんゆう	杉本健勇	固有一般
けんゆう	健勇	固有人名
すぎもとそうたろう	杉本崇太朗	固有一般
そうたろう	崇太朗	固有人名
すぎもとたいが	杉本大雅	固有一般
すぎもとたくや	杉本拓也	固有一般
すぎもとたろう	杉本太郎	固有一般
すぎもとだいち	杉本大地	固有一般
すぎもとひろゆき	杉本裕之	固有一般
すぎもとまこと	杉本真	固有一般
すぎもとまさお	杉本雅央	固有一般
まさお	雅央	固有人名
すぎもとまさや	杉本将哉	固有一般
まさや	将哉	固有人名
すぎもとみちはる	杉本倫治	固有一般
みちはる	倫治	固有人名
すぎもとみつき	杉本光希	固有一般
みつき	光希	固有人名
すぎもとりゅうじ	杉本竜士	固有一般
りゅうじ	竜士	固有人名
すぎもりこうき	杉森考起	固有一般
こうき	考起	固有人名
すぎやまあらた	杉山新	固有一般
すぎやまこういち	杉山弘一	固有一般
こういち	弘一	固有人名
すぎやまこうじ	杉山耕二	固有一般
こうじ	耕二	固有人名
すぎやまこうた	杉山浩太	固有一般
こうた	浩太	固有人名
すぎやましゅん	杉山俊	固有一般
すぎやましん	杉山臣	固有一般
しん	臣	固有人名
すぎやまたかまさ	杉山天真	固有一般
たかまさ	天真	固有人名
すぎやまたかゆき	杉山貴之	固有一般
すぎやまたくや	杉山琢也	固有一般
たくや	琢也	固有人名
すぎやまだんと	杉山弾斗	固有一般
だんと	弾斗	固有人名
すぎやまてつ	杉山哲	固有一般
てつ	哲	固有人名
すぎやまなおひろ	杉山直宏	固有一般
すぎやままこと	杉山誠	固有一般
すぎやまりきひろ	杉山力裕	固有一般
りきひろ	力裕	固有人名
すぎやまれお	杉山伶央	固有一般
れお	伶央	固有人名
すぐりひろまさ	村主博正	固有一般
ひろまさ	博正	固有人名
すげのたかのり	菅野孝憲	固有一般
たかのり	孝憲	固有人名
すざききょうへい	須崎恭平	固有一般
すずなおき	鈴直樹	固有一般
すずかげんたろう	鈴鹿源太郎	固有一般
げんたろう	源太郎	固有人名
すずきあきと	鈴木暁登	固有一般
あきと	暁登	固有人名
すずきあきと	鈴木章斗	固有一般
あきと	章斗	固有人名
すずきあさひ	鈴木朝日	固有一般
すずきあやき	鈴木彩貴	固有一般
あやき	彩貴	固有人名
すずきいちろう	鈴木一朗	固有一般
いちろう	一朗	固有人名
すずきかいと	鈴木魁人	固有一般
すずきかいと	鈴木海音	固有一般
かいと	海音	固有人名
すずきかずひろ	鈴木和裕	固有一般
かずひろ	和裕	固有人名
すずきかつひろ	鈴木勝大	固有一般
すずきかずみ	鈴木克美	固有一般
かずみ	克美	固有人名
すずきくにとも	鈴木国友	固有一般
くにとも	国友	固有人名
すずきくらのすけ	鈴木蔵之介	固有一般
くらのすけ	蔵之介	固有人名
すずきけいご	鈴木奎吾	固有一般
けいご	奎吾	固有人名
すずきけいた	鈴木啓太	固有一般
すずきけんしろう	鈴木拳士郎	固有一般
けんしろう	拳士郎	固有人名
すずきけんじ	鈴木健児	固有一般
けんじ	健児	固有人名
すずきけんた	鈴木健太	固有一般
すずきけんたろう	鈴木健太郎	固有一般
すずきこうじ	鈴木孝司	固有一般
こうじ	孝司	固有人名
すずきこうすけ	鈴木浩介	固有一般
こうすけ	浩介	固有人名
すずきこうた	鈴木厚太	固有一般
こうた	厚太	固有人名
すずきさとる	鈴木悟	固有一般
すずきざいおん	鈴木彩艶	固有一般
ざいおん	彩艶	固有人名
すずきしゅうと	鈴木修人	固有一般
すずきしゅん	鈴木俊	固有一般
すずきしゅんのすけ	鈴木駿之助	固有一般
しゅんのすけ	駿之助	固有人名
すずきしゅんや	鈴木俊也	固有一般
しゅんや	俊也	固有人名
すずきしょうた	鈴木将太	固有一般
すずきしょうた	鈴木翔大	固有一般
すずきしょうた	鈴木翔太	固有一般
すずきしょうと	鈴木翔登	固有一般
しょうと	翔登	固有人名
すずきしんご	鈴木慎吾	固有一般
すずきじゅん	鈴木惇	固有一般
じゅん	惇	固有人名
すずきじゅん	鈴木潤	固有一般
すずきじゅん	鈴木淳	固有一般
すずきじゅんのすけ	鈴木淳之介	固有一般
じゅんのすけ	淳之介	固有人名
すずきじゅんや	鈴木順也	固有一般
じゅんや	順也	固有人名
すずきじゅんや	鈴木準弥	固有一般
じゅんや	準弥	固有人名
すずきそう	鈴木颯	固有一般
そう	颯	固有人名
すずきたかあき	鈴木孝明	固有一般
すずきたかふみ	鈴木崇文	固有一般
すずきたかゆき	鈴木敬之	固有一般
たかゆき	敬之	固有人名
すずきたかゆき	鈴木隆行	固有一般
たかゆき	隆行	固有人名
すずきたけひと	鈴木健仁	固有一般
たけひと	健仁	固有人名
すずきたつや	鈴木達也	固有一般
すずきだいすけ	鈴木大輔	固有一般
すずきだいせい	鈴木大誠	固有一般
だいせい	大誠	固有人名
すずきだいち	鈴木大馳	固有一般
だいち	大馳	固有人名
すずきつばさ	鈴木翼	固有一般
すずきといち	鈴木冬一	固有一般
といち	冬一	固有人名
すずきとくま	鈴木徳真	固有一般
とくま	徳真	固有人名
すずきともき	鈴木智樹	固有一般
ともき	智樹	固有人名
すずきともや	鈴木智也	固有一般
すずきともゆき	鈴木智幸	固有一般
すずきのぶたか	鈴木伸貴	固有一般
のぶたか	伸貴	固有人名
すずきのりお	鈴木規郎	固有一般
のりお	規郎	固有人名
すずきはやた	鈴木颯太	固有一般
はやた	颯太	固有人名
すずきはやと	鈴木隼人	固有一般
すずきはると	鈴木陽人	固有一般
はると	陽人	固有人名
すずきひでと	鈴木秀人	固有一般
すずきひなせ	鈴木陽成	固有一般
ひなせ	陽成	固有人名
すずきふみや	鈴木郁也	固有一般
ふみや	郁也	固有人名
すずきふみや	鈴木史哉	固有一般
ふみや	史哉	固有人名
すずきぶるーの	鈴木 ブルーノ	固有一般
すずきまさのり	鈴木将方	固有一般
まさのり	将方	固有人名
すずきまさはる	鈴木正治	固有一般
まさはる	正治	固有人名
すずきまさひと	鈴木正人	固有一般
まさひと	正人	固有人名
すずきまさや	鈴木将也	固有一般
すずきみずき	鈴木瑞生	固有一般
すずきむさし	鈴木武蔵	固有一般
すずきゆいと	鈴木唯人	固有一般
ゆいと	唯人	固有人名
すずきゆうき	鈴木悠希	固有一般
すずきゆうき	鈴木雄貴	固有一般
すずきゆうすけ	鈴木祐輔	固有一般
すずきゆうた	鈴木悠太	固有一般
すずきゆうた	鈴木雄太	固有一般
すずきゆうと	鈴木雄斗	固有一般
すずきゆうま	鈴木優磨	固有一般
ゆうま	優磨	固有人名
すずきよしかず	鈴木良和	固有一般
よしかず	良和	固有人名
すずきよしたけ	鈴木喜丈	固有一般
よしたけ	喜丈	固有人名
すずきよしのり	鈴木義宜	固有一般
よしのり	義宜	固有人名
すずきりゅうが	鈴木隆雅	固有一般
りゅうが	隆雅	固有人名
すずきりゅうせい	鈴木琉世	固有一般
りゅうせい	琉世	固有人名
すずきりょうた	鈴木椋大	固有一般
りょうた	椋大	固有人名
すずきりょうた	鈴木涼汰	固有一般
りょうた	涼汰	固有人名
すずきわだいぶらひーむ	鈴木輪太朗イブラヒーム	固有一般
すずむらたくや	鈴村拓也	固有一般
すだこうすけ	須田興輔	固有一般
こうすけ	興輔	固有人名
すだよしまさ	須田芳正	固有一般
よしまさ	芳正	固有人名
すだりゅうしん	須田龍心	固有一般
りゅうしん	龍心	固有人名
すていまんそたろう	ステイマンＪ草太郎	固有一般
すとうなおき	須藤直輝	固有一般
すとうわたる	須藤渉	固有一般
すどうたかふみ	須藤貴郁	固有一般
たかふみ	貴郁	固有人名
すどうだいすけ	須藤大輔	固有一般
すどうゆうすけ	須藤右介	固有一般
ゆうすけ	右介	固有人名
すなかわまこと	砂川誠	固有一般
すながわたいし	砂川太志	固有一般
たいし	太志	固有人名
すなだたくみ	砂田匠	固有一般
すなもりかずや	砂森和也	固有一般
すみけんしん	角健心	固有一般
けんしん	健心	固有人名
すみこうしろう	角昂志郎	固有一般
こうしろう	昂志郎	固有人名
すみこたろう	隅廣太郎	固有一般
こたろう	廣太郎	固有人名
すみせいが	鷲見星河	固有一般
せいが	星河	固有人名
すみらいむ	角来夢	固有一般
らいむ	来夢	固有人名
すみだしょう	住田将	固有一般
すみだたかひこ	住田貴彦	固有一般
たかひこ	貴彦	固有人名
すみながかける	住永翔	固有一般
すみのあいと	住野碧音	固有一般
あいと	碧音	固有人名
すみのはるき	隅野遥喜	固有一般
すみよしじぇらにれしょーん	住吉ジェラニレショーン	固有一般
じぇらにれしょーん	ジェラニレショーン	固有人名
すわゆうだい	諏訪雄大	固有一般
すわぞのかずよし	諏訪園一吉	固有一般
かずよし	一吉	固有人名
すわまこせい	諏訪間幸成	固有一般
こせい	幸成	固有人名
ずけやまいっしん	瑞慶山一真	固有一般
いっしん	一真	固有人名
ずしこうしろう	圖師好至郎	固有一般
こうしろう	好至郎	固有人名
せいけそうた	清家颯太	固有一般
せいじたいが	清治大雅	固有一般
せいたなおや	清田奈央弥	固有一般
なおや	奈央弥	固有人名
せいのともあき	清野智秋	固有一般
ともあき	智秋	固有人名
せがわかずき	瀬川和樹	固有一般
せがわまこと	瀬川誠	固有一般
せがわゆうすけ	瀬川祐輔	固有一般
せきかいと	関海斗	固有一般
せきけんたろう	関憲太郎	固有一般
けんたろう	憲太郎	固有人名
せきこうじ	関浩二	固有一般
せきたかし	関貴史	固有一般
せきたかみち	関隆倫	固有一般
たかみち	隆倫	固有人名
せきみつひろ	関光博	固有一般
みつひろ	光博	固有人名
せきゆうと	関祐斗	固有一般
ゆうと	祐斗	固有人名
せきりゅうせい	関龍聖	固有一般
せきがわいくま	関川郁万	固有一般
いくま	郁万	固有人名
せきぐちかいしん	関口凱心	固有一般
かいしん	凱心	固有人名
せきぐちくんみつ	関口訓充	固有一般
くんみつ	訓充	固有人名
せきぐちけいすけ	関口圭亮	固有一般
けいすけ	圭亮	固有人名
せきぐちじょう	関口丈	固有一般
せきぐちまさひろ	関口正大	固有一般
まさひろ	正大	固有人名
せきたひろし	関田寛士	固有一般
ひろし	寛士	固有人名
せきどけんじ	関戸健二	固有一般
せきねえいご	関根永悟	固有一般
えいご	永悟	固有人名
せきねたかひろ	関根貴大	固有一般
せきねひろき	関根大輝	固有一般
ひろき	大輝	固有人名
せきのあいき	関野愛紀	固有一般
あいき	愛紀	固有人名
せきのきっぺい	関野喜平	固有一般
きっぺい	喜平	固有人名
せきのげんや	関野元弥	固有一般
げんや	元弥	固有人名
せきはらりょうが	関原凌河	固有一般
りょうが	凌河	固有人名
せきもとこういち	関本恒一	固有一般
こういち	恒一	固有人名
せきやひかる	関谷輝	固有一般
せぐちたくや	瀬口拓弥	固有一般
せこあゆむ	瀬古歩夢	固有一般
せこかんじ	瀬古寛治	固有一般
かんじ	寛治	固有人名
せこたつき	瀬古樹	固有一般
せせひろと	世瀬啓人	固有一般
せそこせいや	瀬底正椰	固有一般
せいや	正椰	固有人名
せっつはやと	摂津颯登	固有一般
はやと	颯登	固有人名
せとたかゆき	瀬戸貴幸	固有一般
たかゆき	貴幸	固有人名
せとはるき	瀬戸春樹	固有一般
せとぐちなおと	瀬戸口脩人	固有一般
なおと	脩人	固有人名
せぬままさかず	瀬沼正和	固有一般
せぬまゆうじ	瀬沼優司	固有一般
ゆうじ	優司	固有人名
せのおなおや	妹尾直哉	固有一般
せのおりゅうすけ	妹尾隆佑	固有一般
りゅうすけ	隆佑	固有人名
せはたぎじょう	瀬畠義成	固有一般
ぎじょう	義成	固有人名
せやまかずき	瀬山航生	固有一般
かずき	航生	固有人名
せらだけんいち	世良田顕一	固有一般
けんいち	顕一	固有人名
せりざわひゅう	芹澤飛勇	固有一般
ひゅう	飛勇	固有人名
せんごくれん	仙石廉	固有一般
せんざきかつや	先崎勝也	固有一般
かつや	勝也	固有人名
せんだいがくと	仙臺岳斗	固有一般
がくと	岳斗	固有人名
せんとうけいや	仙頭啓矢	固有一般
けいや	啓矢	固有人名
せんばたいし	仙波大志	固有一般
せんぷくそうた	泉福創太	固有一般
そくわんすー	徐冠秀	固有一般
くわんすー	冠秀	固有人名
そとめたつみ	早乙女達海	固有一般
たつみ	達海	固有人名
そうまじょう	相馬丞	固有一般
じょう	丞	固有人名
そうまたかひと	相馬崇人	固有一般
たかひと	崇人	固有人名
そうまなおき	相馬直樹	固有一般
そうまゆうき	相馬勇紀	固有一般
ゆうき	勇紀	固有人名
そえだたかし	添田隆司	固有一般
たかし	隆司	固有人名
そがだいち	曽我大地	固有一般
そがはたひとし	曽ヶ端準	固有一般
ひとし	準	固有人名
そがべけいた	曽我部慶太	固有一般
そたかずあき	曽田一騎	固有一般
かずあき	一騎	固有人名
そだゆうし	曽田雄志	固有一般
ゆうし	雄志	固有人名
そてつこうき	蘓鉄航生	固有一般
そのだゆたか	曽根田穣	固有一般
ゆたか	穣	固有人名
そのだしゅうた	其田秀太	固有一般
そのだしゅん	園田駿	固有一般
そのだしょうた	薗田尚大	固有一般
しょうた	尚大	固有人名
そのだじゅん	薗田淳	固有一般
そのだたくま	薗田卓馬	固有一般
たくま	卓馬	固有人名
そのだたくや	園田拓也	固有一般
そめのいつき	染野唯月	固有一般
いつき	唯月	固有人名
そめやかずき	染矢一樹	固有一般
そめやけい	染谷奎	固有一般
けい	奎	固有人名
そめやゆうた	染谷悠太	固有一般
そやとしかず	征矢智和	固有一般
としかず	智和	固有人名
そりまちかずき	反町一輝	固有一般
そりまちやすはる	反町康治	固有一般
やすはる	康治	固有人名
そんしゅんこう	孫峻崗	固有一般
しゅんこう	峻崗	固有人名
そんせいほう	宋勝鳳	固有一般
せいほう	勝鳳	固有人名
たいらさとし	平聡	固有一般
たいらせいたろう	平誠太朗	固有一般
せいたろう	誠太朗	固有人名
たいらともひろ	平智広	固有一般
ともひろ	智広	固有人名
たおけいすけ	田尾佳祐	固有一般
たおはると	田尾日寿	固有一般
はると	日寿	固有人名
たかいかずま	高井和馬	固有一般
たかいこうた	高井幸大	固有一般
こうた	幸大	固有人名
たかいわりゅうせい	高岩流星	固有一般
りゅうせい	流星	固有人名
たかえれお	髙江麗央	固有一般
れお	麗央	固有人名
たかおりゅう	髙尾瑠	固有一般
りゅう	瑠	固有人名
たかおりゅうせい	髙尾流星	固有一般
たかおかようへい	高丘陽平	固有一般
たかきじゅんぺい	高木純平	固有一般
たかきなりた	高木成太	固有一般
なりた	成太	固有人名
たかぎあきと	髙木 彰人	固有一般
たかぎかずまさ	高木和正	固有一般
たかぎかずみち	高木和道	固有一般
かずみち	和道	固有人名
たかぎけんじ	高木健旨	固有一般
けんじ	健旨	固有人名
たかぎしどう	髙木獅道	固有一般
しどう	獅道	固有人名
たかぎしゅん	高木駿	固有一般
たかぎせん	高木践	固有一般
せん	践	固有人名
たかぎたかひろ	高木貴弘	固有一般
たかひろ	貴弘	固有人名
たかぎたくや	高木琢也	固有一般
たかぎだいすけ	高木大輔	固有一般
たかぎとしや	高木利弥	固有一般
としや	利弥	固有人名
たかぎとしゆき	高木俊幸	固有一般
としゆき	俊幸	固有人名
たかぎゆうや	高木友也	固有一般
ゆうや	友也	固有人名
たかぎよしあき	高木善朗	固有一般
よしあき	善朗	固有人名
たかぎよしなり	高木義成	固有一般
よしなり	義成	固有人名
たかぎしけんしん	髙岸憲伸	固有一般
けんしん	憲伸	固有人名
たかぎわとおる	高木和徹	固有一般
たかくぼけんと	髙窪健人	固有一般
たかくわだいじろう	高桑大二朗	固有一般
だいじろう	大二朗	固有人名
たかさきこうき	髙崎弘輝	固有一般
こうき	弘輝	固有人名
たかさきてんしろう	高崎天史郎	固有一般
てんしろう	天史郎	固有人名
たかさきひろゆき	高崎寛之	固有一般
たかさきりき	高嵜理貴	固有一般
りき	理貴	固有人名
たかざわゆうや	髙澤優也	固有一般
たかしおはやせ	高塩隼生	固有一般
はやせ	隼生	固有人名
たかしまこうしろう	高島康四郎	固有一般
こうしろう	康四郎	固有人名
たかしましゅうや	高嶋修也	固有一般
しゅうや	修也	固有人名
たかすゆうだい	高須雄大	固有一般
たかすようへい	高須洋平	固有一般
たかすかさとみ	髙須賀惺峯	固有一般
さとみ	惺峯	固有人名
たかせあきら	高瀬証	固有一般
あきら	証	固有人名
たかせかずな	髙瀨和楠	固有一般
かずな	和楠	固有人名
たかせたいせい	髙瀨太聖	固有一般
たいせい	太聖	固有人名
たかせたいち	高瀬太一	固有一般
たかせゆうこう	高瀬 優孝	固有一般
たかたじゅん	高田純	固有一般
たかたたいおう	高田大鳳	固有一般
たいおう	大鳳	固有人名
たかだえいじ	高田栄二	固有一般
えいじ	栄二	固有人名
たかだせいや	高田聖也	固有一般
たかだそうた	髙田蒼太	固有一般
たかだそうや	髙田颯也	固有一般
そうや	颯也	固有人名
たかだてつや	高田哲也	固有一般
たかだまさあき	高田昌明	固有一般
まさあき	昌明	固有人名
たかだやすのり	高田保則	固有一般
やすのり	保則	固有人名
たかだりょうた	髙田椋汰	固有一般
りょうた	椋汰	固有人名
たかちけいじ	髙地系治	固有一般
けいじ	系治	固有人名
たかつかせいや	高塚星弥	固有一般
せいや	星弥	固有人名
たかぬきたいえい	高貫太瑛	固有一般
たいえい	太瑛	固有人名
たかのこうじ	高野光司	固有一般
こうじ	光司	固有人名
たかのこうへい	高野耕平	固有一般
たかのしゅうや	髙野秀哉	固有一般
たかのなつき	高野捺貴	固有一般
なつき	捺貴	固有人名
たかのりょう	高野遼	固有一般
たかはぎようじろう	髙萩洋次郎	固有一般
ようじろう	洋次郎	固有人名
たかはしいっせい	髙橋壱晟	固有一般
いっせい	壱晟	固有人名
たかはしいっぺい	高橋一平	固有一般
たかはしかえで	髙橋楓	固有一般
かえで	楓	固有人名
たかはしかずき	高橋和希	固有一般
たかはしかずき	髙橋一輝	固有一般
たかはしけい	高橋佳	固有一般
けい	佳	固有人名
たかはしけいご	高橋慶伍	固有一般
けいご	慶伍	固有人名
たかはしけんごう	高橋謙豪	固有一般
けんごう	謙豪	固有人名
たかはしけんじ	髙橋健史	固有一般
たかはしけんじ	高橋健二	固有一般
たかはしげんいち	高橋厳一	固有一般
げんいち	厳一	固有人名
たかはしこうが	高橋昂雅	固有一般
こうが	昂雅	固有人名
たかはしこうだい	高橋昂大	固有一般
こうだい	昂大	固有人名
たかはしこうへい	高橋耕平	固有一般
たかはししいば	高橋思瓜芭	固有一般
しいば	思瓜芭	固有人名
たかはししゅうた	高橋周大	固有一般
しゅうた	周大	固有人名
たかはししゅんき	高橋峻希	固有一般
しゅんき	峻希	固有人名
たかはししゅんた	高橋駿太	固有一般
たかはししょうへい	高橋祥平	固有一般
たかはししんいちろう	高橋真一郎	固有一般
しんいちろう	真一郎	固有人名
たかはしじゅんや	高橋潤哉	固有一般
じゅんや	潤哉	固有人名
たかはしすばる	高橋昴	固有一般
たかはしそうや	高橋壮也	固有一般
そうや	壮也	固有人名
たかはしたいよう	髙橋太陽	固有一般
たかはしたく	高橋拓	固有一般
たかはしたくや	高橋拓也	固有一般
たかはしただお	高橋忠男	固有一般
ただお	忠男	固有人名
たかはしだいご	髙橋大悟	固有一般
たかはしだいすけ	高橋大輔	固有一般
たかはしとしき	髙橋利樹	固有一般
としき	利樹	固有人名
たかはしともや	高橋友矢	固有一般
ともや	友矢	固有人名
たかはしなおき	高橋直樹	固有一般
たかはしなおき	高橋尚紀	固有一般
たかはしなおや	髙橋直也	固有一般
たかはしなおや	高橋直也	固有一般
たかはしなるき	髙橋成樹	固有一般
なるき	成樹	固有人名
たかはしのりお	高橋範夫	固有一般
のりお	範夫	固有人名
たかはしひかる	高橋輝	固有一般
たかはしひでと	高橋秀人	固有一般
たかはしひでのり	高橋秀典	固有一般
たかはしひろと	髙橋優仁	固有一般
ひろと	優仁	固有人名
たかはしひろゆき	高橋宏幸	固有一般
ひろゆき	宏幸	固有人名
たかはしまさひろ	高橋昌大	固有一般
まさひろ	昌大	固有人名
たかはしまなと	高橋真士	固有一般
まなと	真士	固有人名
たかはしゆう	高橋悠	固有一般
たかはしゆうしょう	高橋祐翔	固有一般
ゆうしょう	祐翔	固有人名
たかはしゆうじ	高橋祐治	固有一般
ゆうじ	祐治	固有人名
たかはしゆうた	髙橋勇太	固有一般
たかはしゆうたろう	高橋祐太郎	固有一般
ゆうたろう	祐太郎	固有人名
たかはしゆうま	高橋悠馬	固有一般
たかはしゆたか	高橋泰	固有一般
ゆたか	泰	固有人名
たかはしゆづき	高橋唯月	固有一般
ゆづき	唯月	固有人名
たかはしゆりや	高橋勇利也	固有一般
ゆりや	勇利也	固有人名
たかはしよしき	高橋義希	固有一般
よしき	義希	固有人名
たかはしよしき	髙橋馨希	固有一般
よしき	馨希	固有人名
たかはしりお	高橋凛央	固有一般
りお	凛央	固有人名
たかはしりゅうた	髙橋隆大	固有一般
たかはしりゅうのすけ	高橋龍ノ介	固有一般
りゅうのすけ	龍ノ介	固有人名
たかはしりょう	高橋亮	固有一般
たかはしりょう	高橋諒	固有一般
たかはしりょうた	高橋良太	固有一般
たかはたけいた	高畑奎汰	固有一般
けいた	奎汰	固有人名
たかはたともや	髙畑智也	固有一般
たかはらとしやす	髙原寿康	固有一般
としやす	寿康	固有人名
たかはらなおひろ	高原直泰	固有一般
なおひろ	直泰	固有人名
たかばやしゆうき	高林佑樹	固有一般
たかべあきら	高部聖	固有一般
あきら	聖	固有人名
たかまつだいき	高松大樹	固有一般
たかまつだいち	高松大智	固有一般
たかみけいた	高見啓太	固有一般
たかみねともき	高嶺朋樹	固有一般
たかもとのりふみ	高本詞史	固有一般
のりふみ	詞史	固有人名
たかもとみきひろ	髙本幹大	固有一般
みきひろ	幹大	固有人名
たかやすたかゆき	高安孝幸	固有一般
たかゆき	孝幸	固有人名
たかやすりょうすけ	高安亮介	固有一般
たかやなぎいっせい	髙柳一誠	固有一般
いっせい	一誠	固有人名
たかやなぎえいじろう	高柳英二郎	固有一般
えいじろう	英二郎	固有人名
たかやなぎこうへい	高柳昂平	固有一般
たかやなぎふみや	高柳郁弥	固有一般
たかやなぎまさよし	高柳昌賢	固有一般
まさよし	昌賢	固有人名
たかやまかおる	高山薫	固有一般
たかやまようへい	高山洋平	固有一般
たかやまりょうじろう	高山椋二朗	固有一般
りょうじろう	椋二朗	固有人名
たかよししょうま	高吉正真	固有一般
しょうま	正真	固有人名
たからきお	高良希生	固有一般
きお	希生	固有人名
たがしらりょうた	田頭亮太	固有一般
たがみあんり	田上亜璃	固有一般
あんり	亜璃	固有人名
たがみだいち	田上大地	固有一般
たがわきょうすけ	田川亨介	固有一般
きょうすけ	亨介	固有人名
たがわともき	田川知樹	固有一般
ともき	知樹	固有人名
たきゆうた	滝裕太	固有一般
たきざわくにひこ	滝澤邦彦	固有一般
くにひこ	邦彦	固有人名
たきざわしゅうへい	瀧澤修平	固有一般
たきざわだん	瀧澤暖	固有一般
たきざわてん	瀧澤天	固有一般
てん	天	固有人名
たきせけんたろう	滝瀬健太郎	固有一般
たきたもえと	瀧田萌人	固有一般
もえと	萌人	固有人名
たきたゆうき	田北雄気	固有一般
ゆうき	雄気	固有人名
たきみずれんたろう	瀧水蓮太郎	固有一般
れんたろう	蓮太郎	固有人名
たきもとはるひこ	滝本晴彦	固有一般
たきやりょう	瀧谷亮	固有一般
たくさがわたかし	田草川貴	固有一般
たくまこうよう	田熊航洋	固有一般
こうよう	航洋	固有人名
たぐちけいた	田口啓太	固有一般
たぐちけんた	田口絢大	固有一般
けんた	絢大	固有人名
たぐちじゅんと	田口潤人	固有一般
じゅんと	潤人	固有人名
たぐちたいし	田口泰士	固有一般
たいし	泰士	固有人名
たぐちたつや	田口達也	固有一般
たぐちひじり	田口聖	固有一般
たぐちゆうや	田口裕也	固有一般
たぐちよしのり	田口禎則	固有一般
よしのり	禎則	固有人名
たけせいや	武星弥	固有一般
たけはやて	武颯	固有一般
たけいせいごう	武井成豪	固有一般
たけいたくや	武井択也	固有一般
たくや	択也	固有人名
たけいゆうま	武井邑馬	固有一般
ゆうま	邑馬	固有人名
たけうちあきら	竹内彬	固有一般
たけうちえいすけ	竹内瑛亮	固有一般
たけうちたかと	竹内崇人	固有一般
たけうちだい	武内大	固有一般
たけうちだいと	竹内大斗	固有一般
だいと	大斗	固有人名
たけうちりゅうま	竹内琉真	固有一般
りゅうま	琉真	固有人名
たけうちりょう	竹内涼	固有一般
たけうちりょうたろう	竹内諒太郎	固有一般
りょうたろう	諒太郎	固有人名
たけおかひろと	竹岡寛人	固有一般
たけおかゆうと	武岡優斗	固有一般
たけざわかずと	武沢一翔	固有一般
かずと	一翔	固有人名
たけしげあきひこ	竹重安希彦	固有一般
あきひこ	安希彦	固有人名
たけしたともや	武下智哉	固有一般
たけしたれお	竹下玲王	固有一般
れお	玲王	固有人名
たけしまゆうじ	竹嶋裕二	固有一般
たけだあやと	武田絢都	固有一般
あやと	絢都	固有人名
たけだえいじろう	武田英二郎	固有一般
たけだしょうへい	武田将平	固有一般
たけだじろう	武田治郎	固有一般
じろう	治郎	固有人名
たけだたいち	武田太一	固有一般
たけだたくま	武田拓真	固有一般
たけだただし	竹田忠嗣	固有一般
ただし	忠嗣	固有人名
たけだだい	武田大	固有一般
たけだなおたけ	武田直隆	固有一般
なおたけ	直隆	固有人名
たけだぬぼひろ	武田修宏	固有一般
ぬぼひろ	修宏	固有人名
たけだぬぼひろ	武田亘弘	固有一般
ぬぼひろ	亘弘	固有人名
たけだひであき	武田英明	固有一般
たけだひでとし	武田英寿	固有一般
ひでとし	英寿	固有人名
たけだひろゆき	武田博行	固有一般
たけだゆうすけ	武田有祐	固有一般
ゆうすけ	有祐	固有人名
たけだゆうせい	武田悠聖	固有一般
たけだようへい	武田洋平	固有一般
たけとみこうすけ	武富孝介	固有一般
こうすけ	孝介	固有人名
たけなかこうき	竹中公基	固有一般
こうき	公基	固有人名
たけなかみのる	竹中穣	固有一般
たけののぞみ	竹野希	固有一般
たけはらきんや	竹原欣也	固有一般
きんや	欣也	固有人名
たけべこうすけ	武部洸佑	固有一般
こうすけ	洸佑	固有人名
たけむらしゅんじ	竹村俊二	固有一般
しゅんじ	俊二	固有人名
たけむらよしや	竹村栄哉	固有一般
よしや	栄哉	固有人名
たけもとしょうた	竹本将太	固有一般
たけもとゆうひ	竹本雄飛	固有一般
ゆうひ	雄飛	固有人名
たけもとよしゆき	竹元義幸	固有一般
よしゆき	義幸	固有人名
たけやむつみ	竹谷睦	固有一般
むつみ	睦	固有人名
たこもとのぶ	田光仁重	固有一般
もとのぶ	仁重	固有人名
たさかかずあき	田坂和昭	固有一般
かずあき	和昭	固有人名
たさかゆうすけ	田坂祐介	固有一般
たざわひろゆき	田沢浩之	固有一般
たざわゆうき	田澤勇気	固有一般
たしまりく	田島凌空	固有一般
たしろこう	田代紘	固有一般
こう	紘	固有人名
たしろひろと	田代寛人	固有一般
たしろまさかず	田代真一	固有一般
まさかず	真一	固有人名
たしろまさや	田代雅也	固有一般
たしろゆうぞう	田代有三	固有一般
ゆうぞう	有三	固有人名
たしろようすけ	田代 容輔	固有一般
たしろりゅうが	田代琉我	固有一般
りゅうが	琉我	固有人名
たじましょうた	田島昇太	固有一般
しょうた	昇太	固有人名
たじまひろあき	田島宏晃	固有一般
たじりけん	田尻健	固有一般
たじりこうせい	田尻康晴	固有一般
こうせい	康晴	固有人名
たたらあつと	多々良敦斗	固有一般
あつと	敦斗	固有人名
ただこうや	多田亘冶	固有一般
こうや	亘冶	固有人名
ただたかゆき	多田高行	固有一般
たかゆき	高行	固有人名
ただだいすけ	多田大介	固有一般
ただゆうき	多田雄貴	固有一般
ただりょうすけ	夛田凌輔	固有一般
りょうすけ	凌輔	固有人名
たてこうき	舘幸希	固有一般
こうき	幸希	固有人名
たちかわこたろう	立川小太郎	固有一般
こたろう	小太郎	固有人名
たちのしゅんすけ	舘野俊祐	固有一般
たちばなあきと	橘章斗	固有一般
たちばなあゆむ	立花歩夢	固有一般
たちばなかずき	橘一輝	固有一般
たちばなこうせい	立花康生	固有一般
たちばなはるき	立花春輝	固有一般
たちばなひびき	立花響	固有一般
たちばなだけんと	橘田健人	固有一般
たつたゆうご	立田悠悟	固有一般
ゆうご	悠悟	固有人名
たていしあすか	立石飛鳥	固有一般
たていしとものり	立石智紀	固有一般
とものり	智紀	固有人名
たてだこうた	舘田晃太	固有一般
たどころりょう	田所諒	固有一般
たなかあお	田中碧	固有一般
あお	碧	固有人名
たなかあとむ	田中亜土夢	固有一般
あとむ	亜土夢	固有人名
たなかかずき	田中和樹	固有一般
たなかかんた	田中勘太	固有一般
たなかきりと	田中輝里十	固有一般
きりと	輝里十	固有人名
たなかぎんじ	田中吟侍	固有一般
ぎんじ	吟侍	固有人名
たなかけいた	田中恵太	固有一般
たなかけんご	田中謙吾	固有一般
たなかけんしん	田中堅清	固有一般
けんしん	堅清	固有人名
たなかけんじ	田中賢治	固有一般
けんじ	賢治	固有人名
たなかこうすけ	田中康介	固有一般
たなかこうたろう	田中洸太朗	固有一般
こうたろう	洸太朗	固有人名
たなかこうへい	田中康平	固有一般
たなかさとし	田中聡	固有一般
たなかしゅうと	田中秀人	固有一般
たなかしゅん	田中舜	固有一般
たなかしゅんいち	田中俊一	固有一般
たなかしゅんた	田中駿汰	固有一般
たなかしょう	田中憧	固有一般
しょう	憧	固有人名
たなかしょう	田中翔	固有一般
たなかしょうま	田中彰馬	固有一般
しょうま	彰馬	固有人名
たなかしんじ	田中真二	固有一般
しんじ	真二	固有人名
たなかしんすけ	田中紳介	固有一般
しんすけ	紳介	固有人名
たなかじげん	田中侍賢	固有一般
じげん	侍賢	固有人名
たなかじゅん	田中淳	固有一般
たなかじゅんぺい	田中純平	固有一般
たなかじゅんや	田中淳也	固有一般
たなかじゅんや	田中順也	固有一般
たなかそういち	田中奏一	固有一般
そういち	奏一	固有人名
たなかそる	田中颯流	固有一般
そる	颯流	固有人名
たなかそら	田中想来	固有一般
そら	想来	固有人名
たなかたいが	田中大雅	固有一般
たなかたかひろ	田中貴大	固有一般
たなかたつや	田中達也	固有一般
たなかだいすけ	田中大輔	固有一般
たなかてつや	田中哲也	固有一般
たなかてるかず	田中輝和	固有一般
たなかてるき	田中輝希	固有一般
てるき	輝希	固有人名
たなかとうあ	田中叶碧	固有一般
とうあ	叶碧	固有人名
たなかとしや	田中俊也	固有一般
たなかとしや	田中稔也	固有一般
としや	稔也	固有人名
たなかともひろ	田中智大	固有一般
ともひろ	智大	固有人名
たなかなおき	田中直基	固有一般
なおき	直基	固有人名
たなかななせ	田中七星	固有一般
ななせ	七星	固有人名
たなかのぶたか	田中信孝	固有一般
のぶたか	信孝	固有人名
たなかはやて	田中颯	固有一般
たなかはやと	田中隼人	固有一般
たなかはゆま	田中隼磨	固有一般
はゆま	隼磨	固有人名
たなかぱうろじゅんいち	田中 パウロ淳一	固有一般
たなかひおら	田中陽己良	固有一般
ひおら	陽己良	固有人名
たなかひでお	田中英雄	固有一般
ひでお	英雄	固有人名
たなかひろき	田中寛己	固有一般
ひろき	寛己	固有人名
たなかひろと	田中裕人	固有一般
ひろと	裕人	固有人名
たなかひろまさ	田中宏昌	固有一般
ひろまさ	宏昌	固有人名
たなかひろむ	田中宏武	固有一般
ひろむ	宏武	固有人名
たなかまこと	田中誠	固有一般
たなかゆうき	田中優毅	固有一般
ゆうき	優毅	固有人名
たなかまるくすとぅーりお	田中 マルクス闘莉王	固有一般
たなかゆうき	田中雄輝	固有一般
ゆうき	雄輝	固有人名
たなかゆうすけ	田中裕介	固有一般
たなかゆうすけ	田中佑昌	固有一般
ゆうすけ	佑昌	固有人名
たなかゆうだい	田中雄大	固有一般
たなかゆうや	田中悠也	固有一般
たなかゆうや	田中優也	固有一般
たなかよしなが	田中慶延	固有一般
よしなが	慶延	固有人名
たなかりく	田中陸	固有一般
たなかりゅうしろう	田中龍志郎	固有一般
りゅうしろう	龍志郎	固有人名
たなかわたる	田中渉	固有一般
たなだしん	棚田伸	固有一般
たなだはやて	棚田颯	固有一般
たなだりょう	棚田遼	固有一般
たなはしあきと	棚橋尭士	固有一般
あきと	尭士	固有人名
たなはしゆうすけ	棚橋雄介	固有一般
たなべかずひこ	田辺和彦	固有一般
たなべけいすけ	田辺圭佑	固有一般
たなべこうへい	田邉光平	固有一般
たなべしゅうと	田邉秀斗	固有一般
たなべそたん	田邉草民	固有一般
そたん	草民	固有人名
たなべようた	田辺陽太	固有一般
たなべりょうた	田鍋陵太	固有一般
りょうた	陵太	固有人名
たにいぶき	谷聖己	固有一般
いぶき	聖己	固有人名
たにこうせい	谷晃生	固有一般
たにしゅんくん	谷俊勲	固有一般
しゅんくん	俊勲	固有人名
たにしんいちろう	谷真一郎	固有一般
たにいけようへい	谷池洋平	固有一般
たにおこうや	谷尾昂也	固有一般
こうや	昂也	固有人名
たにおたかひろ	谷尾隆博	固有一般
たかひろ	隆博	固有人名
たにおかまさし	谷岡昌	固有一般
まさし	昌	固有人名
たにおくけんしろう	谷奥健四郎	固有一般
けんしろう	健四郎	固有人名
たにおくゆうさく	谷奥優作	固有一般
たにかわつよし	谷川烈	固有一般
つよし	烈	固有人名
たにがわしょうすけ	谷川尚翼	固有一般
しょうすけ	尚翼	固有人名
たにがわゆうま	谷川勇磨	固有一般
ゆうま	勇磨	固有人名
たにぐちいさお	谷口功	固有一般
いさお	功	固有人名
たにぐちかいと	谷口海斗	固有一般
たにぐちけい	谷口圭	固有一般
たにぐちけんぞう	谷口堅三	固有一般
けんぞう	堅三	固有人名
たにぐちしょうご	谷口彰悟	固有一般
しょうご	彰悟	固有人名
たにぐちともき	谷口智紀	固有一般
ともき	智紀	固有人名
たにぐちひろと	谷口栄斗	固有一般
ひろと	栄斗	固有人名
たにぐちひろゆき	谷口博之	固有一般
ひろゆき	博之	固有人名
たにぐちゆうすけ	谷口裕介	固有一般
たにぐちりっせい	谷口璃成	固有一般
りっせい	璃成	固有人名
たにぐちりょうや	谷口遼弥	固有一般
りょうや	遼弥	固有人名
たにだそしお	谷田壮志朗	固有一般
そしお	壮志朗	固有人名
たにだれんと	谷田蓮都	固有一般
れんと	蓮都	固有人名
たにむらかいな	谷村海那	固有一般
かいな	海那	固有人名
たにむらけんいち	谷村憲一	固有一般
けんいち	憲一	固有人名
たにむらしゅん	谷村峻	固有一般
たにむらなおや	谷村尚哉	固有一般
なおや	尚哉	固有人名
たにもとくんぺい	谷本薫平	固有一般
たにもとしゅんすけ	谷本駿介	固有一般
たにもとそうたろう	谷本壮太朗	固有一般
そうたろう	壮太朗	固有人名
たにもとゆうき	谷本雄紀	固有一般
ゆうき	雄紀	固有人名
たにやまゆうと	谷山湧人	固有一般
ゆうと	湧人	固有人名
たねおかたかまさ	種岡岐将	固有一般
たかまさ	岐将	固有人名
たねだはるひ	種田陽	固有一般
はるひ	陽	固有人名
たねむらゆうじ	種村優志	固有一般
ゆうじ	優志	固有人名
たのうえしんや	田ノ上信也	固有一般
しんや	信也	固有人名
たのうえだいち	田上大地	固有一般
たのうえゆう	田上裕	固有一般
たのべそう	田野辺創	固有一般
たはらゆうほ	田原悠帆	固有一般
ゆうほ	悠帆	固有人名
たはらゆたか	田原豊	固有一般
たはられんと	田原廉登	固有一般
れんと	廉登	固有人名
たばでぃえご	田場ディエゴ	固有一般
でぃえご	ディエゴ	固有人名
たばしせいや	田橋征也	固有一般
せいや	征也	固有人名
たばたあきひろ	田畑昭宏	固有一般
あきひろ	昭宏	固有人名
たばたあつろう	田畑篤郎	固有一般
あつろう	篤郎	固有人名
たばたてるき	田畑輝樹	固有一般
たばたのぶしげ	田端信成	固有一般
のぶしげ	信成	固有人名
たばたひでのり	田端秀規	固有一般
ひでのり	秀規	固有人名
たばたりゅうせい	田端琉聖	固有一般
りゅうせい	琉聖	固有人名
たばたりん	田畑麟	固有一般
たびらたつや	田平起也	固有一般
たつや	起也	固有人名
たぶちゆう	田渕佑	固有一般
たぶちりゅうじ	田渕 龍二	固有一般
たべいゆう	田部井悠	固有一般
たべいりょう	田部井涼	固有一般
たまいともや	玉井智也	固有一般
たまがわけんた	玉川健太	固有一般
たまがわゆう	玉川由	固有一般
ゆう	由	固有人名
たまきふみや	玉城史也	固有一般
たましろしゅんご	玉城峻吾	固有一般
しゅんご	峻吾	固有人名
たましろたいし	玉城大志	固有一般
たましろゆきや	玉城幸弥	固有一般
ゆきや	幸弥	固有人名
たまだけいじ	玉田圭司	固有一般
けいじ	圭司	固有人名
たまのじゅん	玉乃淳	固有一般
たまばやしむつみ	玉林睦実	固有一般
むつみ	睦実	固有人名
たまるとしき	田丸星輝	固有一般
としき	星輝	固有人名
たむかいたいき	田向泰輝	固有一般
たむらしょうた	田村翔汰	固有一般
たむらしょうた	田村翔太	固有一般
たむらそうき	田村蒼生	固有一般
そうき	蒼生	固有人名
たむらそうすけ	田村聡佑	固有一般
そうすけ	聡佑	固有人名
たむらつばさ	田村翼	固有一般
たむらともや	田村朋也	固有一般
たむらなおひろ	田村直弘	固有一般
なおひろ	直弘	固有人名
たむらなおや	田村直也	固有一般
たむらはやと	田村勇人	固有一般
たむらまさたか	田村仁崇	固有一般
まさたか	仁崇	固有人名
たむらゆう	田村友	固有一般
ゆう	友	固有人名
たむらゆうき	田村祐基	固有一般
ゆうき	祐基	固有人名
たむらゆうぞう	田村雄三	固有一般
ゆうぞう	雄三	固有人名
たむらりょうすけ	田村亮介	固有一般
ためだひろたか	為田大貴	固有一般
たもまさのり	賜正憲	固有一般
まさのり	正憲	固有人名
たもりだいき	田森大己	固有一般
だいき	大己	固有人名
たわらつみだこうた	俵積田晃太	固有一般
たんだいそうや	丹代爽弥	固有一般
そうや	爽弥	固有人名
たんのけんた	丹野研太	固有一般
だいけんじ	代健司	固有一般
だいとうあつむ	大當侑	固有一般
あつむ	侑	固有人名
だいもとりゅうじ	大本竜司	固有一般
だていつき	舘樹	固有一般
だてみちひさ	伊達倫央	固有一般
みちひさ	倫央	固有人名
だんざきりく	檀崎竜孔	固有一般
りく	竜孔	固有人名
だんのせな	檀野世那	固有一般
せな	世那	固有人名
ちあきたかのり	千明聖典	固有一般
たかのり	聖典	固有人名
ちくんしく	崔根植	固有一般
くんしく	根植	固有人名
ちょいじょんはん	崔 正漢	固有一般
ちょいすんくく	崔 成國	固有一般
ちすんぐん	崔誠根	固有一般
すんぐん	誠根	固有人名
ちさんよん	崔成勇	固有一般
さんよん	成勇	固有人名
ちだいしく	崔大植	固有一般
だいしく	大植	固有人名
ちょえびょんぎる	崔炳吉	固有一般
びょんぎる	炳吉	固有人名
ちねいく	崔文植	固有一般
ねいく	文植	固有人名
ちよんす	崔龍洙	固有一般
よんす	龍洙	固有人名
ちかいしてっぺい	近石哲平	固有一般
ちくこうすけ	知久航介	固有一般
こうすけ	航介	固有人名
ちしまとおる	千島徹	固有一般
ちだかいと	千田海人	固有一般
ちだけいと	千田奎斗	固有一般
けいと	奎斗	固有人名
ちだゆうき	千田悠貴	固有一般
ちねんけい	知念慶	固有一般
ちねんてつや	知念哲矢	固有一般
ちねんゆうたろう	知念雄太朗	固有一般
ゆうたろう	雄太朗	固有人名
ちのとしき	千野俊樹	固有一般
としき	俊樹	固有人名
ちばおさむ	千葉修	固有一般
ちばかずひこ	千葉和彦	固有一般
ちばかんた	千葉寛汰	固有一般
かんた	寛汰	固有人名
ちばしんや	千葉真也	固有一般
ちばそうた	千葉奏汰	固有一般
そうた	奏汰	固有人名
ちばたかひと	千葉貴仁	固有一般
たかひと	貴仁	固有人名
ちばたける	千葉武	固有一般
たける	武	固有人名
ちばとらじ	千葉虎士	固有一般
とらじ	虎士	固有人名
ちばなおき	千葉直樹	固有一般
ちばやすのぶ	千葉泰伸	固有一般
やすのぶ	泰伸	固有人名
ちぶかづき	千布一輝	固有一般
かづき	一輝	固有人名
ちゃじほ	車 智鎬	固有一般
ちゃどんぐん	車東訓	固有一般
どんぐん	東訓	固有人名
ちゃじまゆうすけ	茶島雄介	固有一般
ちゃのたかゆき	茶野隆行	固有一般
ちゅうごまさき	中後雅喜	固有一般
まさき	雅喜	固有人名
ちょうぉんひ	趙源熙	固有一般
うぉんひ	源熙	固有人名
ちょどんぎょん	趙東建	固有一般
どんぎょん	東建	固有人名
ちょびょんくく	曺 秉局	固有一般
ちょみんう	趙民宇	固有一般
みんう	民宇	固有人名
ちょよんちょる	曺 永哲	固有一般
ちゃんあおりん	張奥林	固有一般
あおりん	奥林	固有人名
ちょうきじぇ	曺 貴裁	固有一般
ちゃんしゅう	張帥	固有一般
しゅう	帥	固有人名
ちょさんぐわん	趙晟桓	固有一般
さんぐわん	晟桓	固有人名
ちゃうてんし	趙天賜	固有一般
てんし	天賜	固有人名
じょんさんへ	全山海	固有一般
さんへ	山海	固有人名
じょんせうんひゅん	鄭 昇炫	固有一般
じょんしょんぐん	丁成勳	固有一般
しょんぐん	成勳	固有人名
ちょんてせ	鄭大世	固有一般
てせ	大世	固有人名
じょんふんせうん	鄭 薫聖	固有一般
ちょんよんで	鄭容臺	固有一般
よんで	容臺	固有人名
ちよたんだみつる	千代反田充	固有一般
みつる	充	固有人名
ちんゆんか	陳運華	固有一般
ゆんか	運華	固有人名
つかがわこうき	塚川孝輝	固有一般
こうき	孝輝	固有人名
つかだしょうご	塚田翔悟	固有一般
つかだゆうすけ	塚田裕介	固有一般
つかのまさき	塚野真樹	固有一般
つかはらてっしん	塚原輝	固有一般
てっしん	輝	固有人名
つかもとあきまさ	塚本明正	固有一般
あきまさ	明正	固有人名
つかもとたいし	塚本泰史	固有一般
たいし	泰史	固有人名
つかもとだい	塚元大	固有一般
つかもとはやと	塚本颯	固有一般
はやと	颯	固有人名
つかもとひでき	塚本秀樹	固有一般
つくいけいすけ	津久井佳祐	固有一般
つくいたくみ	津久井匠海	固有一般
たくみ	匠海	固有人名
つくたいっとう	營田一燈	固有一般
いっとう	一燈	固有人名
つくだけんすけ	佃賢典	固有一般
けんすけ	賢典	固有人名
つけぎゆうや	附木雄也	固有一般
つしまかつひろ	津島克洋	固有一般
つしまみつとし	津島三敏	固有一般
みつとし	三敏	固有人名
つじしゅうご	辻周吾	固有一般
しゅうご	周吾	固有人名
つじそうた	辻創太	固有一般
つじまさお	辻正男	固有一般
まさお	正男	固有人名
つじいきょうへい	辻井恭平	固有一般
つじおしんじ	辻尾真二	固有一般
つじおかゆうま	辻岡佑真	固有一般
つじのこうだい	辻野航大	固有一般
つじもとしげき	辻本茂輝	固有一般
しげき	茂輝	固有人名
つたはやて	蔦颯	固有一般
つだかずき	津田和樹	固有一般
つだたくま	津田琢磨	固有一般
つだともひろ	津田知宏	固有一般
つちだてつや	土田哲也	固有一般
つちだひさし	土田尚史	固有一般
ひさし	尚史	固有人名
つちはしこうや	土橋公哉	固有一般
こうや	公哉	固有人名
つちはしまさき	土橋正樹	固有一般
つちやかいと	土屋櫂大	固有一般
かいと	櫂大	固有人名
つちやたくみ	土屋巧	固有一般
つちやゆきお	土屋征夫	固有一般
ゆきお	征夫	固有人名
つついのりあき	筒井紀章	固有一般
のりあき	紀章	固有人名
つつみけんご	堤健吾	固有一般
つつみこういち	堤耕一	固有一般
こういち	耕一	固有人名
つつみこんな	堤晃波	固有一般
こんな	晃波	固有人名
つつみしゅんすけ	堤俊輔	固有一般
つつみせいじ	堤聖司	固有一般
つづきりょうた	都築龍太	固有一般
りょうた	龍太	固有人名
つなしまゆうと	綱島悠斗	固有一般
つなだたいし	綱田大志	固有一般
つなみさとし	都並敏史	固有一般
さとし	敏史	固有人名
つなみゆうた	都並優太	固有一般
つねまつとものり	恒松伴典	固有一般
とものり	伴典	固有人名
つねもとけいご	常本佳吾	固有一般
けいご	佳吾	固有人名
つねやすみお	常安澪	固有一般
みお	澪	固有人名
つのだたくみ	角田拓海	固有一般
つのだよしかぜ	角田恵風	固有一般
よしかぜ	恵風	固有人名
つのだりょうたろう	角田涼太朗	固有一般
りょうたろう	涼太朗	固有人名
つはじつき	津覇実樹	固有一般
じつき	実樹	固有人名
つばきなおき	椿直起	固有一般
なおき	直起	固有人名
つぼいかずま	坪井一真	固有一般
つぼいきよしろう	坪井清志郎	固有一般
きよしろう	清志郎	固有人名
つぼいけいすけ	坪井慶介	固有一般
けいすけ	慶介	固有人名
つぼいゆうや	坪井湧也	固有一般
ゆうや	湧也	固有人名
つぼうちしゅうすけ	坪内秀介	固有一般
しゅうすけ	秀介	固有人名
つぼかわひろゆき	坪川潤之	固有一般
ひろゆき	潤之	固有人名
つぼごらいき	坪郷来紀	固有一般
らいき	来紀	固有人名
つまがりいっせい	津曲一誠	固有一般
つみたけいすけ	積田景介	固有一般
けいすけ	景介	固有人名
つむらかずき	津村和希	固有一般
つゆきかずと	筑城和人	固有一般
つるいりせい	鶴井李成	固有一般
りせい	李成	固有人名
つるたかいと	鶴田海人	固有一般
つるたこせい	鶴田剛生	固有一般
こせい	剛生	固有人名
つるたたつや	鶴田達也	固有一般
つるたみちひろ	鶴田道弘	固有一般
みちひろ	道弘	固有人名
つるのたいき	鶴野太貴	固有一般
つるのれいじゅ	鶴野怜樹	固有一般
れいじゅ	怜樹	固有人名
つるまきけんと	弦巻健人	固有一般
つるみとしたか	鶴見聡貴	固有一般
としたか	聡貴	固有人名
つるみともよし	鶴見智美	固有一般
ともよし	智美	固有人名
てしまかずき	手島和希	固有一般
てしまひで	手嶋秀	固有一般
ひで	秀	固有人名
てつとひろし	鐡戸裕史	固有一般
ひろし	裕史	固有人名
てづかこうへい	手塚康平	固有一般
てづかなおき	手塚直樹	固有一般
てづかりゅうせい	手塚琉惺	固有一般
りゅうせい	琉惺	固有人名
てらおりょうた	寺尾遼太	固有一般
てらおかまさひろ	寺岡真弘	固有一般
まさひろ	真弘	固有人名
てらかどりく	寺門陸	固有一般
てらかわよしと	寺川能人	固有一般
よしと	能人	固有人名
てらさかしょうご	寺阪尚悟	固有一般
しょうご	尚悟	固有人名
てらさわゆうた	寺沢優太	固有一般
てらしたとうわ	寺下翔和	固有一般
とうわ	翔和	固有人名
てらしまはるひ	寺島はるひ	固有一般
てらだしゅうへい	寺田周平	固有一般
てらだしんいち	寺田紳一	固有一般
しんいち	紳一	固有人名
てらだたけし	寺田武史	固有一般
たけし	武史	固有人名
てらだまさふみ	寺田匡史	固有一般
まさふみ	匡史	固有人名
てらだようすけ	寺田洋介	固有一般
てらぬましもん	寺沼星文	固有一般
しもん	星文	固有人名
てらまえこうた	寺前光太	固有一般
こうた	光太	固有人名
てらむらこうへい	寺村浩平	固有一般
てらやまつばさ	寺山翼	固有一般
てるいあつし	照井篤	固有一般
あつし	篤	固有人名
てるやまはやと	照山颯人	固有一般
でぃびっどそんじゅんまーかす	ディビッドソン純マーカス	固有一般
じゅんまーかす	純マーカス	固有人名
でいしょうたろう	出井正太郎	固有一般
しょうたろう	正太郎	固有人名
でおかだいき	出岡大輝	固有一般
とうしぃた	藤海太	固有一般
しぃた	海太	固有人名
とうごうつばさ	東郷翼	固有一般
とじようすけ	田路耀介	固有一般
ようすけ	耀介	固有人名
とうじょうあつき	東條敦輝	固有一般
あつき	敦輝	固有人名
とぼうはるが	當房悠雅	固有一般
はるが	悠雅	固有人名
とうましな	當真蒔音	固有一般
しな	蒔音	固有人名
とうまたけふみ	當間建文	固有一般
たけふみ	建文	固有人名
とうまはやて	當麻颯	固有一般
とうやさとき	東家聡樹	固有一般
さとき	聡樹	固有人名
とうやましょうじ	唐山翔自	固有一般
しょうじ	翔自	固有人名
とうりりよん	桃李理永	固有一般
りよん	理永	固有人名
とおのだいや	遠野大弥	固有一般
だいや	大弥	固有人名
とうやまゆうき	遠山悠希	固有一般
とうやまゆうと	遠山湧斗	固有一般
ゆうと	湧斗	固有人名
とがしけいまん	富樫敬真	固有一般
けいまん	敬真	固有人名
とがしこういち	冨樫剛一	固有一般
こういち	剛一	固有人名
とがしゆうた	富樫佑太	固有一般
とがわけんた	戸川健太	固有一般
ときおかひろまさ	時岡宏昌	固有一般
ときさきゆう	時崎悠	固有一般
ときさきるい	時崎塁	固有一般
ときざわさとし	常澤聡	固有一般
ときしじん	時志仁	固有一般
ときたこうへい	土岐田洸平	固有一般
こうへい	洸平	固有人名
ときたしゅうさく	鴇田周作	固有一般
しゅうさく	周作	固有人名
ときだまさと	常田克人	固有一般
まさと	克人	固有人名
ときひさしょうご	時久省吾	固有一般
しょうご	省吾	固有人名
ときわきょうた	常盤亨太	固有一般
きょうた	亨太	固有人名
ときわさとし	常盤聡	固有一般
とくいはるま	得居大真	固有一般
はるま	大真	固有人名
とくしげけんた	徳重健太	固有一般
とくしげたかあき	徳重隆明	固有一般
たかあき	隆明	固有人名
とくたけまさゆき	徳武正之	固有一般
まさゆき	正之	固有人名
とくだほまれ	徳田誉	固有一般
とくだゆうま	徳田佑真	固有一般
とくどめじん	徳留尽	固有一般
とくながこうたろう	徳永晃太郎	固有一般
とくながゆうだい	徳永裕大	固有一般
とくながゆうへい	徳永悠平	固有一般
ゆうへい	悠平	固有人名
とくのそうき	得能草生	固有一般
そうき	草生	固有人名
とくもとかなた	徳本奏太	固有一般
かなた	奏太	固有人名
とくもとゆうへい	徳元悠平	固有一般
とくらけん	都倉賢	固有一般
けん	賢	固有人名
とくらけんいちろう	戸倉健一郎	固有一般
けんいちろう	健一郎	固有人名
とさりくう	土佐陸翼	固有一般
りくう	陸翼	固有人名
とざきまさき	登崎雅貴	固有一般
まさき	雅貴	固有人名
としだゆうせい	土信田悠生	固有一般
ゆうせい	悠生	固有人名
としまあきら	戸島章	固有一般
としまさちろう	戸嶋祥郎	固有一般
さちろう	祥郎	固有人名
とだいぶき	戸田伊吹	固有一般
いぶき	伊吹	固有人名
とだかずゆき	戸田和幸	固有一般
とだたかよし	戸田賢良	固有一般
たかよし	賢良	固有人名
とだひろと	戸田大翔	固有一般
とだみつひろ	戸田光洋	固有一般
みつひろ	光洋	固有人名
とだかひろき	戸高弘貴	固有一般
ひろき	弘貴	固有人名
とつかてつや	戸塚哲也	固有一般
とねいっせい	戸根一誓	固有一般
いっせい	一誓	固有人名
とねりょうすけ	刀根亮輔	固有一般
とねるい	利根瑠偉	固有一般
るい	瑠偉	固有人名
とのいけだいすけ	外池大亮	固有一般
だいすけ	大亮	固有人名
とばとしまさ	鳥羽俊正	固有一般
としまさ	俊正	固有人名
とびたゆうだい	飛田裕大	固有一般
とみいえいじ	富井英司	固有一般
とみいだいき	富居大樹	固有一般
とみかわゆうと	富川勇斗	固有一般
とみくだかずま	冨久田和真	固有一般
とみさかゆうじん	冨坂優仁	固有一般
とみざわせいたろう	富澤清太郎	固有一般
せいたろう	清太郎	固有人名
とみざわまさや	富澤雅也	固有一般
とみしまひとし	冨嶋均	固有一般
ひとし	均	固有人名
とみたこうへい	冨田康平	固有一般
とみたしんご	富田晋伍	固有一般
しんご	晋伍	固有人名
とみたしんや	冨田晋矢	固有一般
しんや	晋矢	固有人名
とみただいすけ	冨田大介	固有一般
とみたやすひと	富田康仁	固有一般
やすひと	康仁	固有人名
とみどころゆう	富所悠	固有一般
とみながにじなな	冨永虹七	固有一般
にじなな	虹七	固有人名
とみながひであき	富永英明	固有一般
とみながやすひろ	富永康博	固有一般
やすひろ	康博	固有人名
とみなりしんじ	冨成慎司	固有一般
とみやおが	冨谷央雅	固有一般
おが	央雅	固有人名
とみやすたけひろ	冨安健洋	固有一般
たけひろ	健洋	固有人名
とみやまたかみつ	富山貴光	固有一般
とみやまたつゆき	冨山達行	固有一般
たつゆき	達行	固有人名
とむらそういちろう	戸村総一郎	固有一般
そういちろう	総一郎	固有人名
ともざわごうき	友澤剛気	固有一般
ごうき	剛気	固有人名
ともざわたかき	友澤貴気	固有一般
たかき	貴気	固有人名
ともちかとしあき	友近聡朗	固有一般
としあき	聡朗	固有人名
ともよせじあん	友寄慈安	固有一般
じあん	慈安	固有人名
ともりきいち	友利貴一	固有一般
きいち	貴一	固有人名
ともりたいよう	友利太虹	固有一般
たいよう	太虹	固有人名
ともりゆうしろう	友利祐志朗	固有一般
ゆうしろう	祐志朗	固有人名
とよまけいた	外山佳大	固有一般
けいた	佳大	固有人名
とよまりょう	外山凌	固有一般
とよかわゆうた	豊川雄太	固有一般
とよしまかいと	豊島海斗	固有一般
とよしまゆうさく	豊嶋邑作	固有一般
ゆうさく	邑作	固有人名
とよだあゆむ	豊田歩	固有一般
とよだこうき	豊田晃大	固有一般
こうき	晃大	固有人名
とよだしょうた	豊田将大	固有一般
しょうた	将大	固有人名
とよだやすひろ	豊田泰広	固有一般
やすひろ	泰広	固有人名
とよだようへい	豊田陽平	固有一般
とりいひろと	鳥居大人	固有一般
ひろと	大人	固有人名
とりいづかのぶひと	鳥居塚伸人	固有一般
のぶひと	伸人	固有人名
とりうみこうじ	鳥海晃司	固有一般
とりかいゆうや	鳥養祐矢	固有一般
ゆうや	祐矢	固有人名
とりかいよしき	鳥海芳樹	固有一般
よしき	芳樹	固有人名
とりがいりょうへい	鳥飼椋平	固有一般
りょうへい	椋平	固有人名
どいかんた	土肥幹太	固有一般
どいこき	土井紅貴	固有一般
こき	紅貴	固有人名
どいこうへい	土井康平	固有一般
どいしゅうた	土居柊太	固有一般
どいしょうま	土居聖真	固有一般
しょうま	聖真	固有人名
どいともゆき	土井智之	固有一般
どいひでと	土井秀徒	固有一般
ひでと	秀徒	固有人名
どいよういち	土肥洋一	固有一般
どいよしと	土井嘉人	固有一般
どいよしのり	土居義典	固有一般
よしのり	義典	固有人名
どいりょうた	土井良太	固有一般
どあんゆう	堂安憂	固有一般
ゆう	憂	固有人名
どあんりつ	堂安律	固有一般
りつ	律	固有人名
どがきりゅういち	堂柿龍一	固有一般
りゅういち	龍一	固有人名
どはなかずき	堂鼻起暉	固有一般
かずき	起暉	固有人名
どもとひろと	道本大飛	固有一般
ひろと	大飛	固有人名
どもりかつとし	堂森勝利	固有一般
かつとし	勝利	固有人名
どえんしゅうへい	土遠修平	固有一般
どだてけんと	土館賢人	固有一般
どばしひろゆき	土橋宏由樹	固有一般
ひろゆき	宏由樹	固有人名
どひこうだい	土肥航大	固有一般
なそうす	羅 誠洙	固有一般
ないとうけいすけ	内藤圭佑	固有一般
ないとうけんた	内藤健太	固有一般
ないとうじゅん	内藤潤	固有一般
ないとうともやす	内藤友康	固有一般
ともやす	友康	固有人名
ないとうなおき	内藤直樹	固有一般
ないとうなるゆき	内藤就行	固有一般
なるゆき	就行	固有人名
ないとうのぶひろ	内藤修弘	固有一般
のぶひろ	修弘	固有人名
ないとうやまと	内藤大和	固有一般
ないとうようへい	内藤洋平	固有一般
なかいえいと	中井英人	固有一般
えいと	英人	固有人名
なかいかなで	中井奏	固有一般
かなで	奏	固有人名
なかいしょうご	中井昇吾	固有一般
しょうご	昇吾	固有人名
なかいたかと	中井崇仁	固有一般
たかと	崇仁	固有人名
なかいだいき	中井大翔	固有一般
だいき	大翔	固有人名
なかいよしき	中井義樹	固有一般
よしき	義樹	固有人名
なかおあつし	中尾篤人	固有一般
あつし	篤人	固有人名
なかおこうき	中尾洸稀	固有一般
こうき	洸稀	固有人名
なかおこうじ	中尾康二	固有一般
こうじ	康二	固有人名
なかおこうたろう	中尾幸太郎	固有一般
なかおつよし	中尾剛	固有一般
なかがきりゅういちろう	中垣龍一朗	固有一般
りゅういちろう	龍一朗	固有人名
なかがわかざき	中川風希	固有一般
かざき	風希	固有人名
なかがわそう	中川創	固有一般
なかがわてるひと	仲川輝人	固有一般
てるひと	輝人	固有人名
なかがわはぐむ	中川育	固有一般
はぐむ	育	固有人名
なかがわひろと	中川裕仁	固有一般
ひろと	裕仁	固有人名
なかがわひろと	中川寛斗	固有一般
ひろと	寛斗	固有人名
なかがわまさひこ	中河昌彦	固有一般
まさひこ	昌彦	固有人名
なかがわゆうじ	中川雄二	固有一般
なかがわようすけ	中川洋介	固有一般
なかがわよしかつ	中川義貴	固有一般
よしかつ	義貴	固有人名
なかごみまさゆき	中込正行	固有一般
まさゆき	正行	固有人名
なかさかゆうや	中坂勇哉	固有一般
ゆうや	勇哉	固有人名
なかさきはやと	中崎颯人	固有一般
なかざとこういち	中里晃一	固有一般
こういち	晃一	固有人名
なかざとこうじ	中里宏司	固有一般
こうじ	宏司	固有人名
なかざとたかひろ	中里崇宏	固有一般
たかひろ	崇宏	固有人名
なかざとゆうま	仲里勇真	固有一般
なかざわかいり	中澤海吏	固有一般
かいり	海吏	固有人名
なかざわそうた	中澤聡太	固有一般
なかざわともひで	中澤友秀	固有一般
ともひで	友秀	固有人名
なかざわゆうじ	中澤佑二	固有一般
ゆうじ	佑二	固有人名
なかしおだいき	中塩大貴	固有一般
なかしまきりと	中島聖翔	固有一般
きりと	聖翔	固有人名
なかしまけんせい	中島賢星	固有一般
けんせい	賢星	固有人名
なかしまこうへい	中島康平	固有一般
なかしまたいか	中島大嘉	固有一般
たいか	大嘉	固有人名
なかしまたいき	中島大貴	固有一般
たいき	大貴	固有人名
なかしまたけし	中島豪	固有一般
たけし	豪	固有人名
なかしまひろみ	中島宏海	固有一般
ひろみ	宏海	固有人名
なかしまゆうき	中島裕希	固有一般
ゆうき	裕希	固有人名
なかしまゆうだい	中嶋雄大	固有一般
なかしまようのすけ	中島洋之介	固有一般
ようのすけ	洋之介	固有人名
なかじまあつき	中島惇希	固有一般
あつき	惇希	固有人名
なかじまこうじ	中島浩司	固有一般
なかじましゅん	中島舜	固有一般
なかじましゅんいち	中島俊一	固有一般
なかじましょうや	中島翔哉	固有一般
なかじまじょう	中嶋譲	固有一般
じょう	譲	固有人名
なかじまたいが	中島大雅	固有一般
なかじまたかのり	中島崇典	固有一般
たかのり	崇典	固有人名
なかじまたくま	中島拓真	固有一般
なかじまちかぜ	中島千風	固有一般
ちかぜ	千風	固有人名
なかじまもとひこ	中島元彦	固有一般
もとひこ	元彦	固有人名
なかじまよたろう	中島洋太朗	固有一般
よたろう	洋太朗	固有人名
なかじまよしき	仲島義貴	固有一般
よしき	義貴	固有人名
なかじまれいじ	中島礼司	固有一般
れいじ	礼司	固有人名
なかずみかい	中角海音	固有一般
かい	海音	固有人名
なかたいちぞう	中田一三	固有一般
いちぞう	一三	固有人名
なかたけんたろう	中田健太郎	固有一般
なかたこうじ	中田浩二	固有一般
なかたしゅんき	中田舜貴	固有一般
しゅんき	舜貴	固有人名
なかたひでとし	中田英寿	固有一般
なかたゆうだい	中田湧大	固有一般
ゆうだい	湧大	固有人名
なかたようすけ	中田洋介	固有一般
なかたにきよし	中谷喜代志	固有一般
きよし	喜代志	固有人名
なかたにしんのすけ	中谷進之介	固有一般
しんのすけ	進之介	固有人名
なかたにちょうた	中谷超太	固有一般
ちょうた	超太	固有人名
なかたにゆうすけ	中谷勇介	固有一般
なかだけんじ	仲田建二	固有一般
けんじ	建二	固有人名
なかだじゅのん	中田樹音	固有一般
じゅのん	樹音	固有人名
なかだひろき	中田大貴	固有一般
なかだゆうき	中田祐暉	固有一般
ゆうき	祐暉	固有人名
なかだようへい	中田洋平	固有一般
なかだいしょうた	中台翔太	固有一般
なかだちたくと	仲達拓斗	固有一般
たくと	拓斗	固有人名
なかつぼやすた	中坪優汰	固有一般
やすた	優汰	固有人名
なかつるしょうご	中津留奨吾	固有一般
しょうご	奨吾	固有人名
なかどいみのる	中土井稔	固有一般
なかにしえいすけ	中西永輔	固有一般
えいすけ	永輔	固有人名
なかにしけんと	中西健人	固有一般
なかにしてつお	中西哲生	固有一般
てつお	哲生	固有人名
なかにしてつや	中西哲也	固有一般
なかにしともや	中西倫也	固有一般
ともや	倫也	固有人名
なかにしのりまさ	中西規真	固有一般
のりまさ	規真	固有人名
なかのかつや	中野克哉	固有一般
なかのけい	中野圭	固有一般
なかのけいいちろう	中野圭一郎	固有一般
けいいちろう	圭一郎	固有人名
なかのけいた	中野桂太	固有一般
なかのこうへい	中埜航平	固有一般
なかのこじろう	中野小次郎	固有一般
なかのしゅうと	中野就斗	固有一般
しゅうと	就斗	固有人名
なかのしんや	中野伸哉	固有一般
しんや	伸哉	固有人名
なかのせいや	中野誠也	固有一般
なかのそうた	中野颯大	固有一般
そうた	颯大	固有人名
なかのたける	仲野丈翔	固有一般
たける	丈翔	固有人名
なかのだい	中野大	固有一般
なかのようじ	中野洋司	固有一般
ようじ	洋司	固有人名
なかのまさおみ	中野雅臣	固有一般
まさおみ	雅臣	固有人名
なかのゆうた	中野裕太	固有一般
なかのゆうや	中野優也	固有一般
なかのよしひろ	中野嘉大	固有一般
よしひろ	嘉大	固有人名
なかのりゅうと	中野龍斗	固有一般
りゅうと	龍斗	固有人名
なかのりゅうま	中野瑠馬	固有一般
りゅうま	瑠馬	固有人名
なかはらしゅうと	中原秀人	固有一般
なかはらしょうご	中原彰吾	固有一般
しょうご	彰吾	固有人名
なかはらそら	中原蒼空	固有一般
なかはらたかゆき	中原貴之	固有一般
なかはらだん	中原弾	固有一般
だん	弾	固有人名
なかはらひかる	中原輝	固有一般
なかはらゆうせい	中原優生	固有一般
ゆうせい	優生	固有人名
なかはらいだいすけ	中払大介	固有一般
なかばやしひろつぐ	中林洋次	固有一般
ひろつぐ	洋次	固有人名
なかばやしまさと	中林優友	固有一般
まさと	優友	固有人名
なかまはやと	仲間隼斗	固有一般
はやと	隼斗	固有人名
なかまちこうすけ	中町公祐	固有一般
こうすけ	公祐	固有人名
なかまるしんたろう	仲丸慎太郎	固有一般
なかみけいや	中美慶哉	固有一般
けいや	慶哉	固有人名
なかむらあつたか	中村充孝	固有一般
あつたか	充孝	固有人名
なかむらありゅう	中村亜龍	固有一般
ありゅう	亜龍	固有人名
なかむらかいと	中村海渡	固有一般
かいと	海渡	固有人名
なかむらきょうが	仲村京雅	固有一般
きょうが	京雅	固有人名
なかむらきよし	中村樹佳	固有一般
きよし	樹佳	固有人名
なかむらけいた	中村慶太	固有一般
なかむらけいと	中村敬斗	固有一般
けいと	敬斗	固有人名
なかむらけんご	中村憲剛	固有一般
けんご	憲剛	固有人名
なかむらけんと	中村健人	固有一般
なかむらこうき	中村宏輝	固有一般
こうき	宏輝	固有人名
なかむらこうすけ	中村航輔	固有一般
こうすけ	航輔	固有人名
なかむらこうせい	中村幸聖	固有一般
こうせい	幸聖	固有人名
なかむらごう	中村豪	固有一般
なかむらしゅん	中村駿	固有一般
なかむらしゅんすけ	中村俊輔	固有一般
なかむらしゅんた	中村駿太	固有一般
なかむらしん	中村伸	固有一般
なかむらじゅんや	中村隼也	固有一般
じゅんや	隼也	固有人名
なかむらじろう	中村仁郎	固有一般
じろう	仁郎	固有人名
なかむらせいご	中村成吾	固有一般
せいご	成吾	固有人名
なかむらたいすけ	中村太亮	固有一般
なかむらたいち	中村太一	固有一般
なかむらたくみ	中村拓海	固有一般
なかむらたすく	中村将	固有一般
たすく	将	固有人名
なかむらただし	中村忠	固有一般
ただし	忠	固有人名
なかむらだいき	中村太記	固有一般
だいき	太記	固有人名
なかむらつばさ	中村翼	固有一般
なかむらとうや	中村桐耶	固有一般
とうや	桐耶	固有人名
なかむらとしき	中村俊貴	固有一般
としき	俊貴	固有人名
なかむらなおし	中村直志	固有一般
なおし	直志	固有人名
なかむらはやと	中村隼	固有一般
なかむらひでゆき	中村英之	固有一般
なかむらひろひと	中村洋仁	固有一般
ひろひと	洋仁	固有人名
なかむらふみあき	中村文昭	固有一般
ふみあき	文昭	固有人名
なかむらほくと	中村北斗	固有一般
なかむらほたか	中村帆高	固有一般
ほたか	帆高	固有人名
なかむらまなぶ	中村学	固有一般
なかむらゆうき	中村祐輝	固有一般
なかむらゆうすけ	中村友亮	固有一般
ゆうすけ	友亮	固有人名
なかむらゆうま	中村優真	固有一般
ゆうま	優真	固有人名
なかむらゆうや	中村祐哉	固有一般
ゆうや	祐哉	固有人名
なかむらゆうや	中村祐也	固有一般
ゆうや	祐也	固有人名
なかむらゆら	仲村優良	固有一般
ゆら	優良	固有人名
なかむらよしき	中村香紀	固有一般
よしき	香紀	固有人名
なかむらよしろう	中村祥朗	固有一般
よしろう	祥朗	固有人名
なかむらりゅうが	中村龍雅	固有一般
りゅうが	龍雅	固有人名
なかむらりゅうが	中村琉雅	固有一般
りゅうが	琉雅	固有人名
なかむらりゅうせい	中村琉聖	固有一般
なかむらりょう	中村亮	固有一般
なかむらりょう	中村涼	固有一般
なかむらりょうた	中村亮太	固有一般
なかむらりょうたろう	中村亮太朗	固有一般
りょうたろう	亮太朗	固有人名
なかもとかずし	中本一志	固有一般
かずし	一志	固有人名
なかもりだいすけ	中森大介	固有一般
なかやまあつき	中山温樹	固有一般
あつき	温樹	固有人名
なかやまかいほ	中山開帆	固有一般
かいほ	開帆	固有人名
なかやまかずや	中山和弥	固有一般
かずや	和弥	固有人名
なかやまかつひろ	中山克広	固有一般
かつひろ	克広	固有人名
なかやまげんき	中山元気	固有一般
なかやまさとし	中山悟志	固有一般
さとし	悟志	固有人名
なかやまのぼる	中山昇	固有一般
なかやまひろき	中山博貴	固有一般
ひろき	博貴	固有人名
なかやままさし	中山雅史	固有一般
まさし	雅史	固有人名
なかやままさと	中山仁斗	固有一般
まさと	仁斗	固有人名
なかやまゆうき	中山雄希	固有一般
なかやまゆうた	中山雄太	固有一般
なかやまゆうと	中山雄登	固有一般
ゆうと	雄登	固有人名
なかやまりく	中山陸	固有一般
なかよしゆうじ	中吉裕司	固有一般
ながいあつし	永井篤志	固有一般
ながいえいじ	永井英次	固有一般
えいじ	英次	固有人名
ながいかずま	長井一真	固有一般
ながいけんご	永井堅梧	固有一般
けんご	堅梧	固有人名
ながいけんすけ	永井謙佑	固有一般
けんすけ	謙佑	固有人名
ながいしおん	永井心温	固有一般
しおん	心温	固有人名
ながいしゅんた	永井俊太	固有一般
ながいそうた	永井颯太	固有一般
ながいたつなり	永井建成	固有一般
たつなり	建成	固有人名
ながいひでき	永井秀樹	固有一般
ながいひびき	長井響	固有一般
ながいゆういちろう	永井雄一郎	固有一般
ながいりょう	永井龍	固有一般
りょう	龍	固有人名
ながいしたくみ	永石拓海	固有一般
ながいしやまと	永石大和	固有一般
ながえゆうま	長江裕真	固有一般
ゆうま	裕真	固有人名
ながおこうた	長尾航太	固有一般
こうた	航太	固有人名
ながおたいせい	長尾泰成	固有一般
たいせい	泰成	固有人名
ながおゆうと	長尾優斗	固有一般
ながかわかんた	永川寛太	固有一般
ながきりょうた	永木亮太	固有一般
ながくらはやて	長倉颯	固有一般
ながくらもとき	長倉幹樹	固有一般
もとき	幹樹	固有人名
ながさかゆうと	永坂勇人	固有一般
ながさかよしき	長坂恭樹	固有一般
よしき	恭樹	固有人名
ながさとげんき	永里源気	固有一般
げんき	源気	固有人名
ながさわかずき	長澤和輝	固有一般
ながさわしばたふぁり	長澤シバタファリ	固有一般
ながさわしゅん	長沢駿	固有一般
ながさわしうぁたふぁり	長澤シヴァタファリ	固有一般
しうぁたふぁり	シヴァタファリ	固有人名
ながさわたくみ	長澤卓己	固有一般
たくみ	卓己	固有人名
ながさわたくや	長澤拓哉	固有一般
ながさわてつ	長澤徹	固有一般
てつ	徹	固有人名
ながさわみかぜ	永澤海風	固有一般
みかぜ	海風	固有人名
ながさわみずき	長澤瑞紀	固有一般
みずき	瑞紀	固有人名
ながさわゆうや	長沢祐弥	固有一般
ながさわりょうすけ	永澤竜亮	固有一般
りょうすけ	竜亮	固有人名
ながしまあきひろ	永島昭浩	固有一般
あきひろ	昭浩	固有人名
ながしまこうだい	長島滉大	固有一般
ながしまゆうし	永島悠史	固有一般
ゆうし	悠史	固有人名
ながせはると	永瀬温大	固有一般
はると	温大	固有人名
ながたかずま	永田一真	固有一般
ながたかんた	永田貫太	固有一般
ながたこうたろう	永田滉太朗	固有一般
こうたろう	滉太朗	固有人名
ながたこうだい	永田倖大	固有一般
こうだい	倖大	固有人名
ながたたかし	永田崇	固有一般
ながたたくや	永田拓也	固有一般
ながたみつる	永田充	固有一般
ながたりゅうじ	永田隆二	固有一般
ながたりょうた	永田亮太	固有一般
ながつかあさひ	長塚陽	固有一般
あさひ	陽	固有人名
ながとかつや	永戸勝也	固有一般
ながとあゆむ	永藤歩	固有一般
ながとみゆうや	永冨裕也	固有一般
ながともこういちろう	長友耕一郎	固有一般
こういちろう	耕一郎	固有人名
ながともやまと	長友大和	固有一般
ながともゆうと	長友佑都	固有一般
ゆうと	佑都	固有人名
ながぬまよいち	長沼洋一	固有一般
ながのさとし	長野聡	固有一般
ながのしゅうと	永野修都	固有一般
しゅうと	修都	固有人名
ながのしょうき	長野星輝	固有一般
しょうき	星輝	固有人名
ながのゆうだい	永野雄大	固有一般
ながはしやすひろ	長橋康弘	固有一般
やすひろ	康弘	固有人名
ながはたゆうき	永畑祐樹	固有一般
ながはまてる	永濱天琉	固有一般
てる	天琉	固有人名
ながみつこうき	長光晃輝	固有一般
こうき	晃輝	固有人名
ながみねひろのり	長峯宏範	固有一般
ひろのり	宏範	固有人名
ながみねゆうと	長峰祐斗	固有一般
ながやすかんた	永易柑太	固有一般
かんた	柑太	固有人名
ながやまかずや	長山一也	固有一般
かずや	一也	固有人名
ながやまくにお	永山邦夫	固有一般
ながよしたくま	永芳卓磨	固有一般
ながれはたいき	流羽汰綺	固有一般
たいき	汰綺	固有人名
なぎらともかず	柳楽智和	固有一般
ともかず	智和	固有人名
なぐらたくみ	名倉巧	固有一般
なごしんたろう	名古新太郎	固有一般
しんたろう	新太郎	固有人名
なごしえいこう	名越瑛恆	固有一般
えいこう	瑛恆	固有人名
なすしんや	奈須伸也	固有一般
しんや	伸也	固有人名
なすじんゆう	那須甚有	固有一般
じんゆう	甚有	固有人名
なすそうすけ	那須奏輔	固有一般
そうすけ	奏輔	固有人名
なすだいすけ	那須大亮	固有一般
なすてっぺい	奈須哲平	固有一般
なすかわまさひろ	那須川将大	固有一般
まさひろ	将大	固有人名
なだはるき	灘遥希	固有一般
はるき	遥希	固有人名
なずかよしひろ	名塚善寛	固有一般
よしひろ	善寛	固有人名
なつめゆうき	棗佑喜	固有一般
ゆうき	佑喜	固有人名
なとりあつし	名取篤	固有一般
ななきだかい	七木田快	固有一般
ななみかずさ	名波上総	固有一般
かずさ	上総	固有人名
ななみひろし	名波浩	固有一般
ななむれあおと	七牟禮蒼杜	固有一般
あおと	蒼杜	固有人名
なべしまはるむ	鍋島暖歩	固有一般
はるむ	暖歩	固有人名
なべたあつし	鍋田純志	固有一般
あつし	純志	固有人名
なべたあとむ	鍋田亜人夢	固有一般
あとむ	亜人夢	固有人名
なまずたたいよう	鯰田太陽	固有一般
なもとらい	波本頼	固有一般
ならたつき	奈良竜樹	固有一般
ならやすよし	奈良安剛	固有一般
やすよし	安剛	固有人名
ならさかたくみ	奈良坂巧	固有一般
ならざきこうせい	楢崎光成	固有一般
こうせい	光成	固有人名
ならざきせいごう	楢﨑正剛	固有一般
せいごう	正剛	固有人名
ならざきひろし	奈良﨑寛	固有一般
ひろし	寛	固有人名
ならはしあきら	名良橋晃	固有一般
ならはしたくま	名良橋拓真	固有一般
ならはらよしき	楢原慶輝	固有一般
よしき	慶輝	固有人名
ならばやしひろき	奈良林寛紀	固有一般
ひろき	寛紀	固有人名
ならわゆうた	奈良輪雄太	固有一般
なりさわゆうあん	成澤夢行	固有一般
ゆうあん	夢行	固有人名
なりたきょうすけ	成田恭輔	固有一般
きょうすけ	恭輔	固有人名
なりたりょうすけ	成田諒介	固有一般
りょうすけ	諒介	固有人名
なりやまゆうじ	成山裕治	固有一般
ゆうじ	裕治	固有人名
なるおなおき	鳴尾直軌	固有一般
なおき	直軌	固有人名
なるおかしょう	成岡翔	固有一般
なるおかひかる	成岡輝瑠	固有一般
ひかる	輝瑠	固有人名
なるせしゅんぺい	成瀬竣平	固有一般
しゅんぺい	竣平	固有人名
なるみいつく	鳴海慈	固有一般
いつく	慈	固有人名
なんばひろあき	難波宏明	固有一般
ひろあき	宏明	固有人名
なんぶけんぞう	南部健造	固有一般
けんぞう	健造	固有人名
にいしゅんすけ	新居俊介	固有一般
にいかわおりべ	新川織部	固有一般
おりべ	織部	固有人名
にいざとりょう	新里涼	固有一般
にいぜきせいや	新関成弥	固有一般
せいや	成弥	固有人名
にいむらやすひこ	新村泰彦	固有一般
やすひこ	泰彦	固有人名
にいやましょうち	新井山祥智	固有一般
しょうち	祥智	固有人名
にうかわあゆみ	牲川歩見	固有一般
あゆみ	歩見	固有人名
にかいどうせいや	二階堂正哉	固有一般
せいや	正哉	固有人名
にしこうすけ	西晃佑	固有一般
こうすけ	晃佑	固有人名
にしたける	西洸瑠	固有一般
たける	洸瑠	固有人名
にしだいご	西大伍	固有一般
だいご	大伍	固有人名
にしのりひろ	西紀寛	固有一般
のりひろ	紀寛	固有人名
にしひろのり	西弘則	固有一般
ひろのり	弘則	固有人名
にしまさはる	西政治	固有一般
まさはる	政治	固有人名
にしようすけ	西洋祐	固有一般
にしりんせい	西凜誓	固有一般
りんせい	凜誓	固有人名
にしいたいよう	西井太陽	固有一般
にしおひびき	西尾響	固有一般
にしおりゅうや	西尾隆矢	固有一般
りゅうや	隆矢	固有人名
にしおかけんた	西岡謙太	固有一般
けんた	謙太	固有人名
にしおかせいち	西岡政智	固有一般
せいち	政智	固有人名
にしおかたいし	西岡大志	固有一般
にしおかだいき	西岡大輝	固有一般
にしかたゆたろう	西方優太郎	固有一般
ゆたろう	優太郎	固有人名
にしかわあゆむ	西川歩	固有一般
にしかわこんのすけ	西川幸之介	固有一般
こんのすけ	幸之介	固有人名
にしかわしゅうご	西川周吾	固有一般
にしかわしゅうさく	西川周作	固有一般
にしかわしゅんいちろう	西川駿一郎	固有一般
しゅんいちろう	駿一郎	固有人名
にしかわしょうご	西河翔吾	固有一般
にしかわしんや	西川慎也	固有一般
にしかわじゅん	西川潤	固有一般
にしかわひろと	西川大翔	固有一般
にしかわゆうだい	西川優大	固有一般
ゆうだい	優大	固有人名
にしかわよしひで	西川吉英	固有一般
よしひで	吉英	固有人名
にしがやたかゆき	西ヶ谷隆之	固有一般
にしくぼしゅんすけ	西久保駿介	固有一般
にしぐちりょう	西口諒	固有一般
にしざかとうわ	西坂斗和	固有一般
とうわ	斗和	固有人名
にしざわあきのり	西澤明訓	固有一般
あきのり	明訓	固有人名
にしざわけんた	西澤健太	固有一般
にしざわじゅんじ	西澤淳二	固有一般
じゅんじ	淳二	固有人名
にしざわよしや	西澤代志也	固有一般
よしや	代志也	固有人名
にしじまひろゆき	西嶋弘之	固有一般
ひろゆき	弘之	固有人名
にしじまゆうや	西嶋有矢	固有一般
ゆうや	有矢	固有人名
にしじまりゅうと	西島隆斗	固有一般
りゅうと	隆斗	固有人名
にしたにまさや	西谷正也	固有一般
まさや	正也	固有人名
にしたにりょう	西谷亮	固有一般
にしだかいと	西田快斗	固有一般
にしだかずと	西田一翔	固有一般
にしだごう	西田剛	固有一般
にしだつばさ	西田翼	固有一般
にしだはると	西田春斗	固有一般
はると	春斗	固有人名
にしだまさや	西田将也	固有一般
にしだめぐむ	西田恵	固有一般
めぐむ	恵	固有人名
にしだゆうすけ	西田勇祐	固有一般
ゆうすけ	勇祐	固有人名
にしだゆうた	西田優太	固有一般
にしだよしひろ	西田吉洋	固有一般
よしひろ	吉洋	固有人名
にしどうひさとし	西堂久俊	固有一般
ひさとし	久俊	固有人名
にしのこうへい	西野晃平	固有一般
にしのしょうた	西野奨太	固有一般
しょうた	奨太	固有人名
にしのたいよう	西野太陽	固有一般
にしのたかはる	西野貴治	固有一般
たかはる	貴治	固有人名
にしのつとむ	西野努	固有一般
つとむ	努	固有人名
にしのまこと	西野誠	固有一般
にしのやすまさ	西野泰正	固有一般
やすまさ	泰正	固有人名
にしのうえはやと	西埜植颯斗	固有一般
にしはらこうた	西原広太	固有一般
にしはらたかし	西原誉志	固有一般
たかし	誉志	固有人名
にしはらともき	西原源樹	固有一般
ともき	源樹	固有人名
にしはられお	西原怜央	固有一般
にしばやしなおき	西林直輝	固有一般
にしべようへい	西部洋平	固有一般
にしみはるき	西見斗輝	固有一般
はるき	斗輝	固有人名
にしむらいおり	西村伊織	固有一般
いおり	伊織	固有人名
にしむらかいひ	西村海陽	固有一般
かいひ	海陽	固有人名
にしむらかつき	西村活輝	固有一般
かつき	活輝	固有人名
にしむらがく	西村岳	固有一般
にしむらけいすけ	西村慧祐	固有一般
けいすけ	慧祐	固有人名
にしむらこうじ	西村弘司	固有一般
こうじ	弘司	固有人名
にしむらしょう	西村翔	固有一般
にしむらすばる	西村昴	固有一般
にしむらたくま	西村拓真	固有一般
にしむらたくろう	西村卓朗	固有一般
たくろう	卓朗	固有人名
にしむらはるき	西村遥己	固有一般
にしむらひでき	西村英樹	固有一般
ひでき	英樹	固有人名
にしむらやすふみ	西村恭史	固有一般
やすふみ	恭史	固有人名
にしむらようへい	西村洋平	固有一般
にしむらりょう	西村涼	固有一般
にしむらりょうま	西村竜馬	固有一般
りょうま	竜馬	固有人名
にしむられん	西村蓮音	固有一般
れん	蓮音	固有人名
にしむろりゅうき	西室隆規	固有一般
りゅうき	隆規	固有人名
にしもとたかのぶ	西本卓申	固有一般
たかのぶ	卓申	固有人名
にしもとたつひろ	西本竜洋	固有一般
たつひろ	竜洋	固有人名
にしもとまさたか	西本雅崇	固有一般
まさたか	雅崇	固有人名
にしもりなおと	西森脩斗	固有一般
なおと	脩斗	固有人名
にしもりまさあき	西森正明	固有一般
まさあき	正明	固有人名
にしもりゆうと	西森悠斗	固有一般
にしやかずき	西谷和希	固有一般
にしやけんと	西矢健人	固有一般
にしやゆうき	西谷優希	固有一般
にしやましゅんた	西山峻太	固有一般
しゅんた	峻太	固有人名
にしやまそうた	西山草汰	固有一般
そうた	草汰	固有人名
にしやまたいが	西山大雅	固有一般
にしやまたかひさ	西山貴永	固有一般
たかひさ	貴永	固有人名
にしやまたくみ	西山拓実	固有一般
たくみ	拓実	固有人名
にしやまてっぺい	西山哲平	固有一般
にしやまゆうすけ	西山雄介	固有一般
にしわきてつや	西脇徹也	固有一般
にしわきりょうへい	西脇良平	固有一般
にたどりこうた	似鳥康太	固有一般
にったうみ	新田羽海	固有一般
うみ	羽海	固有人名
にったこうせい	新田洸成	固有一般
こうせい	洸成	固有人名
にっただいすけ	新田大介	固有一般
にったりお	二田理央	固有一般
りお	理央	固有人名
にとまさし	二戸将	固有一般
にのみやかずき	二宮和輝	固有一般
にのみやじよう	二ノ宮慈洋	固有一般
じよう	慈洋	固有人名
にのみやたくむ	仁宮拓夢	固有一般
にのみやはやて	二宮颯	固有一般
にのみやひろし	二宮浩	固有一般
にぱーどりーすひかる	ニパードリース光	固有一般
りーすひかる	リース光	固有人名
にへいつばさ	二瓶翼	固有一般
にわかずや	丹羽一陽	固有一般
かずや	一陽	固有人名
にわしおん	丹羽詩温	固有一般
しおん	詩温	固有人名
にわたくみ	丹羽匠	固有一般
にわだいき	丹羽大輝	固有一般
にわりゅうへい	丹羽竜平	固有一般
ぬきまさと	貫真郷	固有一般
まさと	真郷	固有人名
ぬきなこせい	貫名航世	固有一般
こせい	航世	固有人名
ぬくいはやと	温井駿斗	固有一般
ぬのべたかのり	布部陽功	固有一般
たかのり	陽功	固有人名
ぬまだいき	沼大希	固有一般
ぬまたけいご	沼田圭悟	固有一般
けいご	圭悟	固有人名
ぬまたこうせい	沼田航征	固有一般
こうせい	航征	固有人名
ぬまたすかい	沼田皇海	固有一般
すかい	皇海	固有人名
ぬまたたかや	沼田駿也	固有一般
たかや	駿也	固有人名
ぬりしりょう	塗師亮	固有一般
ねかどひろき	根角裕基	固有一般
ひろき	裕基	固有人名
ねぎこうき	根木洸希	固有一般
こうき	洸希	固有人名
ねこたつや	根子達也	固有一般
ねじまりょうた	子島諒大	固有一般
りょうた	諒大	固有人名
ねじめしんご	根占真伍	固有一般
ねびきけんすけ	根引謙介	固有一般
ねもとけいすけ	根本圭輔	固有一般
ねもとこたろう	根本鼓太郎	固有一般
こたろう	鼓太郎	固有人名
ねもとゆういち	根本裕一	固有一般
ねもとりょう	根本凌	固有一般
ねもとりょうすけ	根本亮助	固有一般
りょうすけ	亮助	固有人名
ねやましょうご	根山翔伍	固有一般
しょうご	翔伍	固有人名
のじゅん	盧廷潤	固有一般
じゅん	廷潤	固有人名
のいちごう	乃一悟生	固有一般
ごう	悟生	固有人名
のがいとしゅん	野垣内俊	固有一般
のがみたくや	野上拓哉	固有一般
のがみゆうき	野上結貴	固有一般
ゆうき	結貴	固有人名
のがみりゅうせい	野上琉成	固有一般
りゅうせい	琉成	固有人名
のぐちこうじ	野口幸司	固有一般
こうじ	幸司	固有人名
のぐちそうた	野口颯汰	固有一般
のぐちたつひこ	野口竜彦	固有一般
のぐちひろし	野口裕司	固有一般
ひろし	裕司	固有人名
のぐちりょうた	野口遼太	固有一般
のぐちれの	埜口怜乃	固有一般
れの	怜乃	固有人名
のぐちわたる	野口航	固有一般
のざきけいた	野崎桂太	固有一般
のざきまさや	野崎雅也	固有一般
のざきようすけ	野崎陽介	固有一般
のざわけんいち	野澤健一	固有一般
のざわたいしぶらんどん	野澤大志ブランドン	固有一般
のざわたくや	野沢拓也	固有一般
のざわひでゆき	野澤英之	固有一般
のざわようすけ	野澤洋輔	固有一般
ようすけ	洋輔	固有人名
のざわりく	野澤陸	固有一般
のざわれおん	野澤零温	固有一般
れおん	零温	固有人名
のじまりょう	野嶋良	固有一般
のずえさとる	野末学	固有一般
さとる	学	固有人名
のせりゅうせい	野瀬龍世	固有一般
りゅうせい	龍世	固有人名
のだあいと	野田愛斗	固有一般
あいと	愛斗	固有人名
のだあきひろ	野田明弘	固有一般
あきひろ	明弘	固有人名
のだきょうへい	野田恭平	固有一般
のだこうじ	野田紘史	固有一般
こうじ	紘史	固有人名
のださとる	野田知	固有一般
さとる	知	固有人名
のだしんぺい	野田秦平	固有一般
しんぺい	秦平	固有人名
のだたつき	野田樹	固有一般
のだゆうき	野田裕喜	固有一般
ゆうき	裕喜	固有人名
のだひろと	野田大翔	固有一般
のだりゅうのすけ	野田隆之介	固有一般
のだけじゅんや	野嶽惇也	固有一般
じゅんや	惇也	固有人名
のだけひろや	野嶽寛也	固有一般
ひろや	寛也	固有人名
のつまさきよ	野津真聖	固有一般
まさきよ	真聖	固有人名
のつだがくと	野津田岳人	固有一般
がくと	岳人	固有人名
のとまさひと	能登正人	固有一般
ののしたしょうじ	埜下荘司	固有一般
しょうじ	荘司	固有人名
ののむらたかと	野々村鷹人	固有一般
たかと	鷹人	固有人名
ののむらよしかず	野々村芳和	固有一般
よしかず	芳和	固有人名
のはらけんた	野原健太	固有一般
のべゆうた	延祐太	固有一般
のぼりおけんとく	登尾顕徳	固有一般
けんとく	顕徳	固有人名
のぼりさかのぶひろ	登坂信裕	固有一般
のぶひろ	信裕	固有人名
のぼりざときょうへい	登里享平	固有一般
きょうへい	享平	固有人名
のみやまひでき	野見山秀樹	固有一般
のむらてんま	野村天真	固有一般
てんま	天真	固有人名
のむらとしあき	野村俊瑛	固有一般
としあき	俊瑛	固有人名
のむらなおき	野村直輝	固有一般
のむらまさたか	野村政孝	固有一般
まさたか	政孝	固有人名
のむらゆうき	野村祐暉	固有一般
のむらゆうと	野村勇仁	固有一般
ゆうと	勇仁	固有人名
のむらりつき	野村吏希	固有一般
りつき	吏希	固有人名
のもとやすたか	野本泰崇	固有一般
やすたか	泰崇	固有人名
のもとやすひろ	野本安啓	固有一般
やすひろ	安啓	固有人名
のよりかずや	野寄和哉	固有一般
はせきしゅう	河錫舟	固有一般
せきしゅう	錫舟	固有人名
はかまたゆうたろう	袴田裕太郎	固有一般
はがあさひ	芳賀日陽	固有一般
あさひ	日陽	固有人名
はがひろのぶ	芳賀博信	固有一般
はぎのこだい	萩野滉大	固有一般
こだい	滉大	固有人名
はぎのひであき	萩野英明	固有一般
はぎはらしんや	萩原慎也	固有一般
はぎはらたつろう	萩原達郎	固有一般
たつろう	達郎	固有人名
はぎむらしげのり	萩村滋則	固有一般
しげのり	滋則	固有人名
はぎもとまさき	萩元雅樹	固有一般
まさき	雅樹	固有人名
はぎわらひろたく	萩原洪拓	固有一般
ひろたく	洪拓	固有人名
はずらもとひびき	櫨本響祈	固有一般
ひびき	響祈	固有人名
はしうちゆうや	橋内優也	固有一般
はしうちりょうま	橋内竜真	固有一般
りょうま	竜真	固有人名
はしおかだいき	橋岡大樹	固有一般
はしがきとこういち	橋垣戸光一	固有一般
はしぐちかいいち	橋口開一	固有一般
かいいち	開一	固有人名
はしぐちたくや	橋口拓哉	固有一般
はしぐちまさる	橋口勝	固有一般
はしぐちりきや	橋口力也	固有一般
はしださとし	橋田聡司	固有一般
さとし	聡司	固有人名
はしづめゆうき	橋爪勇樹	固有一般
はしばしょうき	橋場尚貴	固有一般
しょうき	尚貴	固有人名
はしむらゆうた	橋村祐太	固有一般
はしむらりゅうじょせふ	橋村龍ジョセフ	固有一般
りゅうじょせふ	龍ジョセフ	固有人名
はしもときょうすけ	橋本恭輔	固有一般
はしもとけいご	橋本啓吾	固有一般
はしもとけんいち	橋本研一	固有一般
けんいち	研一	固有人名
はしもとけんと	橋本健人	固有一般
はしもとけんと	橋本拳人	固有一般
けんと	拳人	固有人名
はしもとこうじ	橋本晃司	固有一般
はしもとしゅん	橋本峻	固有一般
はしもとじょう	橋本丈	固有一般
はしもとすぐる	橋本卓	固有一般
はしもとそあら	橋本空新	固有一般
そあら	空新	固有人名
はしもとたくと	橋本拓門	固有一般
たくと	拓門	固有人名
はしもとたくみ	橋本巧	固有一般
はしもととしき	橋本俊樹	固有一般
はしもとはやと	橋本早十	固有一般
はやと	早十	固有人名
はしもとひでお	橋本英郎	固有一般
ひでお	英郎	固有人名
はしもとまさと	橋本真人	固有一般
はしもとゆうき	橋本裕貴	固有一般
はしもとゆうじ	橋本雄二	固有一般
はしもとりく	橋本陸	固有一般
はしもとりくと	橋本陸斗	固有一般
はしもとわたる	橋本和	固有一般
わたる	和	固有人名
はしらたにこういち	柱谷幸一	固有一般
こういち	幸一	固有人名
はしらたにてつじ	柱谷哲二	固有一般
てつじ	哲二	固有人名
はじとしあき	羽地登志晃	固有一般
としあき	登志晃	固有人名
はすかわそうだい	蓮川壮大	固有一般
そうだい	壮大	固有人名
はすかわゆうだい	蓮川雄大	固有一般
はすぬましょうた	蓮沼翔太	固有一般
はすみこうせい	羽角康生	固有一般
はすみともひろ	蓮見知弘	固有一般
ともひろ	知弘	固有人名
はせがわあきと	長谷川晶飛	固有一般
あきと	晶飛	固有人名
はせがわあーりあじゃすーる	長谷川アーリアジャスール	固有一般
あーりあじゃすーる	アーリアジャスール	固有人名
はせがわけんた	長谷川健太	固有一般
はせがわこう	長谷川洸	固有一般
こう	洸	固有人名
はせがわこうき	長谷川光基	固有一般
こうき	光基	固有人名
はせがわたいち	長谷川太一	固有一般
はせがわたくみ	長谷川巧	固有一般
はせがわたつや	長谷川竜也	固有一般
はせがわたろう	長谷川太郎	固有一般
はせがわつむぐ	長谷川紡	固有一般
つむぐ	紡	固有人名
はせがわとおる	長谷川徹	固有一般
はせがわとよき	長谷川豊喜	固有一般
とよき	豊喜	固有人名
はせがわはやと	長谷川隼	固有一般
はせがわひろかず	長谷川博一	固有一般
ひろかず	博一	固有人名
はせがわみつる	長谷川満	固有一般
みつる	満	固有人名
はせがわもとき	長谷川元希	固有一般
もとき	元希	固有人名
はせがわゆう	長谷川悠	固有一般
はせがわゆうじ	長谷川雄志	固有一般
ゆうじ	雄志	固有人名
はせがわゆうすけ	長谷川雄介	固有一般
はせがわゆと	長谷川夢叶	固有一般
ゆと	夢叶	固有人名
はせがわよしゆき	長谷川祥之	固有一般
よしゆき	祥之	固有人名
はせがわりょう	長谷川諒	固有一般
はせがわりょう	長谷川凌	固有一般
はせべあやと	長谷部彩翔	固有一般
あやと	彩翔	固有人名
はせべしげとし	長谷部茂利	固有一般
しげとし	茂利	固有人名
はせべまこと	長谷部誠	固有一般
はたじゅんき	畑潤基	固有一般
じゅんき	潤基	固有人名
はたたいが	畑大雅	固有一般
はたまさき	畑真暉	固有一般
まさき	真暉	固有人名
はたみのる	畑実	固有一般
はたよしひと	畑嘉人	固有一般
よしひと	嘉人	固有人名
はたおひろと	畑尾大翔	固有一般
はたぞえはやと	畑添隼人	固有一般
はただなおき	畑田真輝	固有一般
なおき	真輝	固有人名
はたてしんや	旗手真也	固有一般
はたてれお	旗手怜央	固有一般
はたなかしんのすけ	畠中槙之輔	固有一般
しんのすけ	槙之輔	固有人名
はたなかまきと	畑中槙人	固有一般
はたなかゆうき	畠中佑樹	固有一般
はたなかゆうしろう	畠中勇士朗	固有一般
ゆうしろう	勇士朗	固有人名
はたのごう	波多野豪	固有一般
はたのたかのり	幡野貴紀	固有一般
たかのり	貴紀	固有人名
はたのひろし	波夛野寛	固有一般
はたのゆうま	畑野優真	固有一般
はたのりょうた	畑野遼太	固有一般
はたもとときお	畑本時央	固有一般
ときお	時央	固有人名
はたやませな	畑山聖那	固有一般
せな	聖那	固有人名
はだいっぺい	羽田一平	固有一般
はだけいすけ	羽田敬介	固有一般
はだけんじ	秦賢二	固有一般
はだのせいりゅう	羽田野成琉	固有一般
せいりゅう	成琉	固有人名
はだのそうし	波多野崇史	固有一般
そうし	崇史	固有人名
はっくぼはやて	八久保颯	固有一般
はちすかこうじ	蜂須賀孝治	固有一般
はっかくだいち	八角大智	固有一般
はっかくつよし	八角剛史	固有一般
はつたしんや	初田真也	固有一般
はったなおき	八田直樹	固有一般
はったんだこうへい	八反田康平	固有一般
はっとりかずき	服部一輝	固有一般
はっとりこうた	服部公太	固有一般
こうた	公太	固有人名
はっとりこうた	服部航大	固有一般
こうた	航大	固有人名
はっとりこうへい	服部康平	固有一般
はっとりこうへい	服部航平	固有一般
はっとりたいき	服部大樹	固有一般
はっとりとしひろ	服部年宏	固有一般
としひろ	年宏	固有人名
はっとりひろき	服部浩紀	固有一般
ひろき	浩紀	固有人名
はっぽれお	八方伶央	固有一般
はつせりょう	初瀬亮	固有一般
はとやすひろ	波戸康広	固有一般
やすひろ	康広	固有人名
はないしょう	花井聖	固有一般
しょう	聖	固有人名
はなだちから	花田力	固有一般
ちから	力	固有人名
はなだゆきおみ	花田倖臣	固有一般
ゆきおみ	倖臣	固有人名
はたどじん	端戸仁	固有一般
はなふさみのる	花房稔	固有一般
はなやまえいじ	花山英二	固有一般
はにゅうなおたけ	羽生直剛	固有一般
なおたけ	直剛	固有人名
はねだけんじ	羽田憲司	固有一般
けんじ	憲司	固有人名
はねだけんと	羽田健人	固有一般
はばたこうき	羽畑公貴	固有一般
こうき	公貴	固有人名
はまたいよう	濱大耀	固有一般
たいよう	大耀	固有人名
はまたくみ	濱託巳	固有一般
たくみ	託巳	固有人名
はまおかかずひさ	濱岡和久	固有一般
はまかわはると	濵川遥斗	固有一般
はると	遥斗	固有人名
はまぐちこうせい	濱口功聖	固有一般
こうせい	功聖	固有人名
はまぐちそうた	濱口草太	固有一般
はまさきしき	濱崎史揮	固有一般
しき	史揮	固有人名
はまさきたくま	浜崎拓磨	固有一般
はましたあきら	浜下瑛	固有一般
あきら	瑛	固有人名
はまだかつひろ	濱田克大	固有一般
かつひろ	克大	固有人名
はまだけんしょう	濱田健正	固有一般
けんしょう	健正	固有人名
はまだこたろう	濱田心太朗	固有一般
こたろう	心太朗	固有人名
はまだたけし	濱田武	固有一般
たけし	武	固有人名
はまだたろう	濵田太郎	固有一般
はまだみずき	濱田水輝	固有一般
みずき	水輝	固有人名
はまなまお	濱名真央	固有一般
まお	真央	固有人名
はまのゆうき	濵野勇気	固有一般
はむよんじゅん	咸 泳俊	固有一般
はやかわじゅんぺい	早川隼平	固有一般
じゅんぺい	隼平	固有人名
はやかわともき	早川友基	固有一般
ともき	友基	固有人名
はやかわとものぶ	早川知伸	固有一般
とものぶ	知伸	固有人名
はやかわふみや	早川史哉	固有一般
はやかわよしき	早川嘉紀	固有一般
よしき	嘉紀	固有人名
はやさかつばさ	早坂翼	固有一般
はやさかゆうき	早坂勇希	固有一般
ゆうき	勇希	固有人名
はやさかゆうし	早坂優志	固有一般
ゆうし	優志	固有人名
はやさかりゅうのすけ	早坂龍之介	固有一般
はやさかりょうた	早坂良太	固有一般
はやしあきひろ	林彰洋	固有一般
あきひろ	彰洋	固有人名
はやしかずあき	林一章	固有一般
かずあき	一章	固有人名
はやしかずき	林一輝	固有一般
はやしかんた	林莞太	固有一般
かんた	莞太	固有人名
はやしけいすけ	林佳祐	固有一般
はやしけんご	林賢吾	固有一般
はやしけんたろう	林健太郎	固有一般
はやしこうき	林航輝	固有一般
こうき	航輝	固有人名
はやしこたろう	林幸多郎	固有一般
こたろう	幸多郎	固有人名
はやしこうへい	林晃平	固有一般
はやしさとる	林慧	固有一般
さとる	慧	固有人名
はやししょうご	林昇吾	固有一般
はやししょうた	林祥太	固有一般
はやししょうたろう	林祥太郎	固有一般
しょうたろう	祥太郎	固有人名
はやしそう	林壮	固有一般
そう	壮	固有人名
はやしそたろう	林奏太朗	固有一般
そたろう	奏太朗	固有人名
はやしそら	林碧良	固有一般
そら	碧良	固有人名
はやしたくと	林卓人	固有一般
たくと	卓人	固有人名
はやしたけのり	林丈統	固有一般
たけのり	丈統	固有人名
はやしたけひろ	林威宏	固有一般
たけひろ	威宏	固有人名
はやしだいち	林大地	固有一般
はやしともや	林友哉	固有一般
はやしなおき	林尚輝	固有一般
はやしひろゆき	林祐征	固有一般
ひろゆき	祐征	固有人名
はやしまさみち	林誠道	固有一般
まさみち	誠道	固有人名
はやしみずき	林瑞輝	固有一般
みずき	瑞輝	固有人名
はやしゆうすけ	林勇介	固有一般
はやしようへい	林容平	固有一般
はやしりくや	林陸也	固有一般
はやしりょうへい	林陵平	固有一般
りょうへい	陵平	固有人名
はやしたかいと	林田魁斗	固有一般
かいと	魁斗	固有人名
はやしたこうや	林田滉也	固有一般
こうや	滉也	固有人名
はやしたともひこ	林田友彦	固有一般
はやしたりゅうすけ	林田隆介	固有一般
はやまごう	端山豪	固有一般
はやましんのすけ	葉山新之輔	固有一般
しんのすけ	新之輔	固有人名
はやまたくみ	羽山拓巳	固有一般
はやみしゅうへい	速水修平	固有一般
はらかずき	原一樹	固有一般
はらかずき	原一貴	固有一般
はらたいち	原大智	固有一般
はらたくや	原拓也	固有一般
はらてるき	原輝綺	固有一般
てるき	輝綺	固有人名
はらなおき	原直生	固有一般
はらのぶき	原信生	固有一般
のぶき	信生	固有人名
はらぶらいあんいけちゅく	原ブライアンイケチュク	固有一般
はらみこと	原尊	固有一般
みこと	尊	固有人名
はらゆうたろう	原裕太郎	固有一般
はらりゅうせい	原龍生	固有一般
はらりゅうた	原竜太	固有一般
はらいかわしょうご	原井川昇吾	固有一般
はらかわりき	原川力	固有一般
りき	力	固有人名
はらぐちげんき	原口元気	固有一般
はらぐちたくと	原口拓人	固有一般
はらぐちゆうじろう	原口祐次郎	固有一般
ゆうじろう	祐次郎	固有人名
はらさきまさと	原崎政人	固有一般
まさと	政人	固有人名
はらざきはやて	原崎颯	固有一般
はらだかんた	原田幹太	固有一般
はらだがく	原田岳	固有一般
はらだけいすけ	原田圭輔	固有一般
はらだこうき	原田虹輝	固有一般
こうき	虹輝	固有人名
はらだこうすけ	原田紘介	固有一般
こうすけ	紘介	固有人名
はらだしんたろう	原田慎太郎	固有一般
はらだたいが	原田大雅	固有一般
はらだたく	原田拓	固有一般
はらだたけお	原田武男	固有一般
たけお	武男	固有人名
はらだなおき	原田直樹	固有一般
はらだひろき	原田拓季	固有一般
ひろき	拓季	固有人名
はらだゆうすけ	原田祐輔	固有一般
はらだよしのぶ	原田欽庸	固有一般
よしのぶ	欽庸	固有人名
はらだわたる	原田亘	固有一般
はらやまかいり	原山海里	固有一般
かいり	海里	固有人名
はりたにたけあき	針谷岳晃	固有一般
たけあき	岳晃	固有人名
はるなりゅうせい	春名竜聖	固有一般
はるやまみさき	晴山岬	固有一般
はれまきたくみ	晴柀匠弥	固有一般
たくみ	匠弥	固有人名
はんじぇみん	韓在民	固有一般
じぇみん	在民	固有人名
はんちゃんじゅ	韓昌柱	固有一般
ちゃんじゅ	昌柱	固有人名
はんほご	韓浩康	固有一般
ほご	浩康	固有人名
はんよんぎ	韓勇岐	固有一般
よんぎ	勇岐	固有人名
はんよんたえ	韓勇太	固有一般
はんざわひかる	半澤光琉	固有一般
ひかる	光琉	固有人名
はんだこうや	半田航也	固有一般
はんだたけし	半田武嗣	固有一般
たけし	武嗣	固有人名
はんだゆうき	半田優希	固有一般
はんだりく	半田陸	固有一般
はんやようすけ	半谷陽介	固有一般
ばばかずひろ	馬場一博	固有一般
かずひろ	一博	固有人名
ばばけんじ	馬場賢治	固有一般
ばばせいや	馬場晴也	固有一般
せいや	晴也	固有人名
ばばたくみ	馬場琢未	固有一般
たくみ	琢未	固有人名
ばばたくみ	馬場卓未	固有一般
たくみ	卓未	固有人名
ばばまさひろ	馬場将大	固有一般
ばばゆうた	馬場憂太	固有一般
ゆうた	憂太	固有人名
ばばゆう	馬場悠	固有一般
ばらだあきみ	茨田陽生	固有一般
あきみ	陽生	固有人名
ばんぐーながんでかしふ	バングーナガンデ佳史扶	固有一般
かしふ	佳史扶	固有人名
ばんだいひろき	萬代宏樹	固有一般
ばんどりゅうじ	播戸竜二	固有一般
ぱくいるぎゅ	朴一圭	固有一般
いるぎゅ	一圭	固有人名
ぱくぎどん	朴基棟	固有一般
ぎどん	基棟	固有人名
ぱくくんは	朴建夏	固有一般
くんは	建夏	固有人名
ぱくじゅんきょん	朴俊慶	固有一般
じゅんきょん	俊慶	固有人名
ぱくじょんす	朴庭秀	固有一般
じょんす	庭秀	固有人名
ぱくじんす	朴鎭琇	固有一般
じんす	鎭琇	固有人名
ぱくせうり	朴昇利	固有一般
せうり	昇利	固有人名
ぱくじせい	朴智星	固有一般
じせい	智星	固有人名
ぱくじゅそん	朴柱成	固有一般
じゅそん	柱成	固有人名
ぱくじょんじん	朴宗眞	固有一般
じょんじん	宗眞	固有人名
ぱくよんご	朴永浩	固有一般
よんご	永浩	固有人名
ぱくりき	朴利基	固有一般
りき	利基	固有人名
ひがこうへい	比嘉厚平	固有一般
こうへい	厚平	固有人名
ひがまさき	比嘉将貴	固有一般
まさき	将貴	固有人名
ひがゆうさく	比嘉雄作	固有一般
ゆうさく	雄作	固有人名
ひがゆうすけ	比嘉祐介	固有一般
ひがりょうと	比嘉諒人	固有一般
りょうと	諒人	固有人名
ひがしかつとし	東克俊	固有一般
かつとし	克俊	固有人名
ひがしけいご	東慶悟	固有一般
けいご	慶悟	固有人名
ひがしこういち	東幸一	固有一般
ひがしこじろう	東胡次郎	固有一般
こじろう	胡次郎	固有人名
ひがししゅん	東駿	固有一般
ひがししゅんき	東俊希	固有一般
しゅんき	俊希	固有人名
ひがしじゅんや	東隼也	固有一般
ひがしじょん	東ジョン	固有一般
じょん	ジョン	固有人名
ひがしりゅうのすけ	東龍之介	固有一般
ひがしれんた	東廉太	固有一般
れんた	廉太	固有人名
ひがしかわよしのり	東川昌典	固有一般
よしのり	昌典	固有人名
ひがしぐちまさあき	東口順昭	固有一般
まさあき	順昭	固有人名
ひがしでそうた	東出壮太	固有一般
ひがしのこうたろう	東野広太郎	固有一般
こうたろう	広太郎	固有人名
ひがしやまたつき	東山達稀	固有一般
たつき	達稀	固有人名
ひきだゆうと	疋田優人	固有一般
ひきちゆうや	曵地裕哉	固有一般
ひきちゆうや	挽地祐哉	固有一般
ひぐちかける	樋口叶	固有一般
かける	叶	固有人名
ひぐちけん	樋口堅	固有一般
けん	堅	固有人名
ひぐちだいき	樋口大輝	固有一般
ひぐちともゆき	樋口知行	固有一般
ともゆき	知行	固有人名
ひぐちひろき	樋口寛規	固有一般
ひろき	寛規	固有人名
ひぐちゆうた	樋口雄太	固有一般
ひぐちようた	樋口耀大	固有一般
ようた	耀大	固有人名
ひぐちりんと	樋口凛人	固有一般
りんと	凛人	固有人名
ひさしまりゅうい	久島隆維	固有一般
りゅうい	隆維	固有人名
ひさとみけん	久富賢	固有一般
ひさどみりょうすけ	久富良輔	固有一般
ひさながたつのり	久永辰徳	固有一般
ひだんさとし	飛弾暁	固有一般
さとし	暁	固有人名
ひだかけいた	日髙慶太	固有一般
ひだかたくま	日高拓磨	固有一般
ひだかともき	日高智樹	固有一般
ひだかともや	日高智也	固有一般
ひだかまさる	日高大	固有一般
ひだかみつき	日髙光揮	固有一般
みつき	光揮	固有人名
ひとみたくや	人見拓哉	固有一般
ひのいっしゅ	日野壱柊	固有一般
いっしゅ	壱柊	固有人名
ひのしょうた	日野翔太	固有一般
ひのすぐる	日野優	固有一般
すぐる	優	固有人名
ひのそら	日野晴天	固有一般
そら	晴天	固有人名
ひめだこうだい	姫田耕大	固有一般
こうだい	耕大	固有人名
ひめのこうりゅう	姫野晃竜	固有一般
こうりゅう	晃竜	固有人名
ひめのそら	姫野青空	固有一般
そら	青空	固有人名
ひめのゆうや	姫野宥弥	固有一般
ゆうや	宥弥	固有人名
ひゃくたけよしなり	百武義成	固有一般
ひゃくだまなと	百田真登	固有一般
ひやまゆうき	檜山勇樹	固有一般
ひょうどうあきひろ	兵働昭弘	固有一般
あきひろ	昭弘	固有人名
ひょうどうけんと	兵藤健斗	固有一般
ひょうどうしんごう	兵藤慎剛	固有一般
しんごう	慎剛	固有人名
ひょんりお	玄理吾	固有一般
りお	理吾	固有人名
ひらしゅうと	平秀斗	固有一般
ひらいしゅんすけ	平井駿助	固有一般
しゅんすけ	駿助	固有人名
ひらいしょうき	平井将生	固有一般
しょうき	将生	固有人名
ひらいしんたろう	平井晋太郎	固有一般
しんたろう	晋太郎	固有人名
ひらいなおひと	平井直人	固有一般
なおひと	直人	固有人名
ひらいりゅうへい	平井龍兵	固有一般
りゅうへい	龍兵	固有人名
ひらいしけんた	平石健太	固有一般
ひらいしなおと	平石直人	固有一般
ひらいでりょう	平出涼	固有一般
ひらおけんしろう	平尾拳士朗	固有一般
けんしろう	拳士朗	固有人名
ひらおしゅうと	平尾柊人	固有一般
ひらおそう	平尾壮	固有一般
ひらおとしき	平尾駿輝	固有一般
としき	駿輝	固有人名
ひらおかたいよう	平岡大陽	固有一般
たいよう	大陽	固有人名
ひらおかたくま	平岡卓磨	固有一般
ひらおかたくみ	平岡拓望​​	固有一般
たくみ	拓望​​	固有人名
ひらおかたすく	平岡翼	固有一般
たすく	翼	固有人名
ひらおかなおき	平岡直起	固有一般
ひらおかひろあき	平岡宏章	固有一般
ひろあき	宏章	固有人名
ひらおかまさひで	平岡将豪	固有一般
まさひで	将豪	固有人名
ひらおかやすなり	平岡靖成	固有一般
やすなり	靖成	固有人名
ひらおかやすひろ	平岡康裕	固有一般
やすひろ	康裕	固有人名
ひらかわけんと	平川絢大	固有一般
けんと	絢大	固有人名
ひらかわげんき	平川元樹	固有一般
げんき	元樹	固有人名
ひらかわたくと	平川拓斗	固有一般
ひらかわただあき	平川忠亮	固有一般
ただあき	忠亮	固有人名
ひらかわひろし	平川弘	固有一般
ひろし	弘	固有人名
ひらかわゆう	平河悠	固有一般
ひらかわれい	平川怜	固有一般
ひらがそら	平賀大空	固有一般
ひらきよしき	平木良樹	固有一般
よしき	良樹	固有人名
ひらさわけんすけ	平澤健介	固有一般
ひらさわたくみ	平澤拓巳	固有一般
ひらしげりゅういち	平繁龍一	固有一般
ひらしまたかし	平島崇	固有一般
ひらせだい	平瀬大	固有一般
ひらせともゆき	平瀬智行	固有一般
ひらたかいと	平田海斗	固有一般
ひらたけい	平田圭	固有一般
ひらたけんいちろう	平田拳一朗	固有一般
けんいちろう	拳一朗	固有人名
ひらたけんと	平田健斗	固有一般
ひらたしゅんすけ	平田駿佑	固有一般
しゅんすけ	駿佑	固有人名
ひらたたけき	平田武暉	固有一般
たけき	武暉	固有人名
ひらたとしひで	平田俊英	固有一般
としひで	俊英	固有人名
ひらつかじろう	平塚次郎	固有一般
ひらつかじん	平墳迅	固有一般
じん	迅	固有人名
ひらつかゆうと	平塚悠知	固有一般
ゆうと	悠知	固有人名
ひらとたいき	平戸太貴	固有一般
ひらのあおい	平野碧	固有一般
ひらのかい	平野甲斐	固有一般
かい	甲斐	固有人名
ひらのたかし	平野孝	固有一般
ひらのゆういち	平野佑一	固有一般
ゆういち	佑一	固有人名
ひらはらりゅうき	平原隆暉	固有一般
りゅうき	隆暉	固有人名
ひらばやしきよひろ	平林輝良寛	固有一般
きよひろ	輝良寛	固有人名
ひらまともかず	平間智和	固有一般
ひらまなおみち	平間直道	固有一般
なおみち	直道	固有人名
ひらまつこうき	平松功輝	固有一般
こうき	功輝	固有人名
ひらまつこうたろう	平松孝汰朗	固有一般
こうたろう	孝汰朗	固有人名
ひらまつこうへい	平松康平	固有一般
ひらまつしゅう	平松宗	固有一般
しゅう	宗	固有人名
ひらまつしょう	平松昇	固有一般
しょう	昇	固有人名
ひらまつだいし	平松大志	固有一般
ひらまつりょうたろう	平松遼太郎	固有一般
ひらまつわたる	平松航	固有一般
ひらもとかずき	平本一樹	固有一般
ひらもとたいすけ	平本大介	固有一般
たいすけ	大介	固有人名
ひらやましゅん	平山駿	固有一般
ひらやまそうた	平山相太	固有一般
そうた	相太	固有人名
ひらやまとものり	平山智規	固有一般
とものり	智規	固有人名
ひらやままさる	平山大	固有一般
ひろいとものぶ	廣井友信	固有一般
とものぶ	友信	固有人名
ひろいらんど	廣井蘭人	固有一般
らんど	蘭人	固有人名
ひろいしそうた	広石宗大	固有一般
そうた	宗大	固有人名
ひろおかむつき	廣岡睦樹	固有一般
むつき	睦樹	固有人名
ひろきゆうま	廣木雄磨	固有一般
ゆうま	雄磨	固有人名
ひろすえりく	廣末陸	固有一般
ひろせおさむ	広瀬治	固有一般
おさむ	治	固有人名
ひろせけんた	広瀬健太	固有一般
ひろせこうじ	廣瀬浩二	固有一般
ひろせともやす	廣瀬智靖	固有一般
ともやす	智靖	固有人名
ひろせともゆき	廣瀬智行	固有一般
ひろせりくと	広瀬陸斗	固有一般
ひろたこうめい	廣田公明	固有一般
こうめい	公明	固有人名
ひろたりゅうじ	廣田 隆治	固有一般
ひろながゆうじ	廣長優志	固有一般
ひろながりゅうき	廣永琉樹	固有一般
りゅうき	琉樹	固有人名
ひろながりょうたろう	廣永遼太郎	固有一般
ひろながれお	廣永獅旺	固有一般
れお	獅旺	固有人名
ひろにわひかる	広庭輝	固有一般
ひろのこういち	広野耕一	固有一般
ひろはたしゅんた	廣畑俊汰	固有一般
しゅんた	俊汰	固有人名
ひろやまのぞみ	廣山望	固有一般
のぞみ	望	固有人名
ぴーだーせんよこん	ピーダーセン世穏	固有一般
よこん	世穏	固有人名
ほわんじんせい	黄辰成	固有一般
じんせい	辰成	固有人名
ふぉんすんみん	黄 順旻	固有一般
ほわんそんす	黄誠秀	固有一般
そんす	誠秀	固有人名
ほわんさんぐん	黄善洪	固有一般
さんぐん	善洪	固有人名
ほわんたいじゅん	黄大俊	固有一般
たいじゅん	大俊	固有人名
ほわんてそん	黄大城	固有一般
てそん	大城	固有人名
ほわんがくじゅん	黄学淳	固有一般
がくじゅん	学淳	固有人名
ふぁんてぃーにあきら	ファンティーニ燦	固有一般
あきら	燦	固有人名
ふえまさと	笛真人	固有一般
ふかいかずき	深井一希	固有一般
ふかいけんじ	深井堅仁	固有一般
けんじ	堅仁	固有人名
ふかいしゅうへい	深井脩平	固有一般
ふかいまさき	深井正樹	固有一般
ふかいゆうき	深井祐希	固有一般
ふかがわだいすけ	深川大輔	固有一般
ふかがわともたか	深川友貴	固有一般
ともたか	友貴	固有人名
ふかざわだいき	深澤大輝	固有一般
ふかざわまさひろ	深澤仁博	固有一般
まさひろ	仁博	固有人名
ふかざわゆうた	深澤佑太	固有一般
ふかざわりく	深澤莉久	固有一般
りく	莉久	固有人名
ふかせはると	深瀬陽斗	固有一般
ふかつこうた	深津康太	固有一般
ふかほりしゅんぺい	深堀隼平	固有一般
しゅんぺい	隼平	固有人名
ふかみこうき	深見光貴	固有一般
ふかみなとそういちろう	深港壮一郎	固有一般
ふかみやまさのり	深宮祐徳	固有一般
まさのり	祐徳	固有人名
ふかやけいすけ	深谷圭佑	固有一般
ふかやゆうき	深谷友基	固有一般
ゆうき	友基	固有人名
ふくいおおじろう	福井大次郎	固有一般
おおじろう	大次郎	固有人名
ふくいかずき	福井和樹	固有一般
ふくいこうき	福井光輝	固有一般
ふくいたいち	福井太智	固有一般
たいち	太智	固有人名
ふくいまさと	福井理人	固有一般
ふくいゆうと	福井悠人	固有一般
ふくいりおん	福井凜音	固有一般
りおん	凜音	固有人名
ふくいりょうじ	福井諒司	固有一般
りょうじ	諒司	固有人名
ふくいれおなるどあきら	福井レオナルド明	固有一般
ふくおうただよ	福王忠世	固有一般
ただよ	忠世	固有人名
ふくおかしょうた	福岡将太	固有一般
ふくおかしんぺい	福岡慎平	固有一般
しんぺい	慎平	固有人名
ふくざきりょうせい	福崎伶青	固有一般
りょうせい	伶青	固有人名
ふくしげりょういち	福重良一	固有一般
ふくしまさとし	福島聡士	固有一般
さとし	聡士	固有人名
ふくしましんた	福島新太	固有一般
しんた	新太	固有人名
ふくしまだいち	福島大地	固有一般
ふくしまはやと	福島隼斗	固有一般
ふくしまはるき	福島春樹	固有一般
ふくしまひろし	福嶋洋	固有一般
ひろし	洋	固有人名
ふくしまりゅうや	福島立也	固有一般
りゅうや	立也	固有人名
ふくしまりゅうや	福島竜弥	固有一般
りゅうや	竜弥	固有人名
ふくしまりょう	福島遼	固有一般
ふくたあきと	福田晃斗	固有一般
あきと	晃斗	固有人名
ふくたひょうま	福田彪馬	固有一般
ひょうま	彪馬	固有人名
ふくたむく	福田武玖	固有一般
むく	武玖	固有人名
ふくたあいお	福田愛大	固有一般
あいお	愛大	固有人名
ふくたけんじ	福田健二	固有一般
ふくたけんすけ	福田健介	固有一般
ふくたけんと	福田健人	固有一般
ふくたしゅんすけ	福田俊介	固有一般
ふくたしゅんた	福田旬汰	固有一般
しゅんた	旬汰	固有人名
ふくたしょう	福田翔生	固有一般
しょう	翔生	固有人名
ふくたしんのすけ	福田心之助	固有一般
しんのすけ	心之助	固有人名
ふくたともや	福田友也	固有一般
ともや	友也	固有人名
ふくたまさひろ	福田正博	固有一般
ふくたみくと	福田望久斗	固有一般
みくと	望久斗	固有人名
ふくたやすひろ	福田恭大	固有一般
やすひろ	恭大	固有人名
ふくたゆうや	福田湧矢	固有一般
ゆうや	湧矢	固有人名
ふくどめけんご	福留健吾	固有一般
ふくどめりょう	福留亮	固有一般
ふくながやすし	福永泰	固有一般
やすし	泰	固有人名
ふくながりょうけい	福永涼敬	固有一般
りょうけい	涼敬	固有人名
ふくにしたかし	福西崇史	固有一般
ふくばとき	福場時	固有一般
とき	時	固有人名
ふくみつたかき	福満隆貴	固有一般
たかき	隆貴	固有人名
ふくむらたかゆき	福村貴幸	固有一般
ふくもとともや	福元友哉	固有一般
ふくもとなおよし	福本尚純	固有一般
なおよし	尚純	固有人名
ふくもとゆう	福本悠	固有一般
ふくもとようへい	福元洋平	固有一般
ふくもりあきと	福森晃斗	固有一般
ふくもりけんた	福森健太	固有一般
ふくもりなおや	福森直也	固有一般
ふけのりき	吹ヶ徳喜	固有一般
のりき	徳喜	固有人名
ふけゆうき	福家勇輝	固有一般
ふこういんまこと	普光院誠	固有一般
ふじなおや	藤直也	固有一般
ふじゆうき	冨士祐樹	固有一般
ふじいかずし	藤井一志	固有一般
ふじいこうだい	藤井航大	固有一般
ふじいこうや	藤井皓也	固有一般
こうや	皓也	固有人名
ふじいしょうた	藤井翔大	固有一般
ふじいたかし	藤井貴	固有一般
ふじいたかゆき	藤井貴之	固有一般
ふじいだいすけ	藤井大輔	固有一般
ふじいともや	藤井智也	固有一般
ふじいはるや	藤井陽也	固有一般
はるや	陽也	固有人名
ふじいひろと	藤井大翔	固有一般
ふじいまさと	藤井柾人	固有一般
まさと	柾人	固有人名
ふじいゆうた	藤井悠太	固有一般
ふじいようた	藤井葉大	固有一般
ようた	葉大	固有人名
ふじおしょうた	藤尾翔太	固有一般
ふじおかこうすけ	藤岡浩介	固有一般
ふじかわこうじ	藤川康司	固有一般
こうじ	康司	固有人名
ふじかわこうたろう	藤川虎太朗	固有一般
こうたろう	虎太朗	固有人名
ふじかわたかゆき	藤川孝幸	固有一般
ふじかわひさたか	藤川久孝	固有一般
ひさたか	久孝	固有人名
ふじかわゆうじ	藤川祐司	固有一般
ふじがきかいき	藤垣介基	固有一般
かいき	介基	固有人名
ふじがやようすけ	藤ヶ谷陽介	固有一般
ふじさきしょうた	藤﨑将汰	固有一般
しょうた	将汰	固有人名
ふじさきともき	藤嵜智貴	固有一般
ともき	智貴	固有人名
ふじさきよしたか	藤崎義孝	固有一般
ふじさきるい	藤崎琉依	固有一般
るい	琉依	固有人名
ふじさわのりたか	藤澤典隆	固有一般
のりたか	典隆	固有人名
ふじさわゆうたろう	藤澤優太朗	固有一般
ゆうたろう	優太朗	固有人名
ふしじまえいすけ	藤嶋栄介	固有一般
えいすけ	栄介	固有人名
ふしじまひかる	藤嶋洸	固有一般
ひかる	洸	固有人名
ふじたいっとう	藤田一途	固有一般
いっとう	一途	固有人名
ふじたいぶき	藤田息吹	固有一般
ふじたかずき	藤田和輝	固有一般
ふじたけん	藤田健	固有一般
ふじたこうへい	藤田浩平	固有一般
ふじたごう	藤田剛	固有一般
ふじたしゅんすけ	藤田峻佑	固有一般
ふじたしんいち	藤田慎一	固有一般
しんいち	慎一	固有人名
ふじたじょうるちま	藤田譲瑠チマ	固有一般
じょうるちま	譲瑠チマ	固有人名
ふじたせいや	藤田征也	固有一般
ふじたたいせい	藤田泰成	固有一般
ふじたとしや	藤田俊哉	固有一般
ふじたなおゆき	藤田直之	固有一般
なおゆき	直之	固有人名
ふじたなるみ	藤田成充	固有一般
なるみ	成充	固有人名
ふじたまさと	藤田優人	固有一般
まさと	優人	固有人名
ふじたみき	藤田樹	固有一般
ふじたやすと	冨士田康人	固有一般
やすと	康人	固有人名
ふじたゆうと	藤田雄士	固有一般
ゆうと	雄士	固有人名
ふじたよしあき	藤田義明	固有一般
ふじたよしひと	藤田祥史	固有一般
よしひと	祥史	固有人名
ふじたよしまさ	藤田芳正	固有一般
ふじたけつよし	藤武剛	固有一般
ふじたにそう	藤谷壮	固有一般
ふじたにたくみ	藤谷匠	固有一般
ふじながたいが	藤永大雅	固有一般
ふじぬまたくむ	藤沼拓夢	固有一般
ふじのかいと	藤野快斗	固有一般
ふじのかずき	藤野和樹	固有一般
ふじのこすも	藤野心魂	固有一般
こすも	心魂	固有人名
ふじのせいや	藤野聖也	固有一般
ふじはしなおゆき	藤橋尚之	固有一般
なおゆき	尚之	固有人名
ふじはらつとむ	藤原務	固有一般
つとむ	務	固有人名
ふじはらなおあつ	藤原尚篤	固有一般
なおあつ	尚篤	固有人名
ふじはらゆうた	藤原悠汰	固有一般
ふじはらよしと	藤原慶人	固有一般
よしと	慶人	固有人名
ふじはるひろき	藤春廣輝	固有一般
ひろき	廣輝	固有人名
ふじまきしょうご	藤牧祥吾	固有一般
しょうご	祥吾	固有人名
ふじまつこうや	藤松航矢	固有一般
こうや	航矢	固有人名
ふじむらけいた	藤村慶太	固有一般
ふじむらりょうへい	藤村涼平	固有一般
ふじむられん	藤村怜	固有一般
ふじもとかずき	藤本一輝	固有一般
ふじもとかんや	藤本寛也	固有一般
かんや	寛也	固有人名
ふじもとこうた	藤本康太	固有一般
ふじもとしゅうじ	藤本修司	固有一般
しゅうじ	修司	固有人名
ふじもとじゅんご	藤本淳吾	固有一般
ふじもとそうま	藤本颯真	固有一般
ふじもとだい	藤本大	固有一般
ふじもとちから	藤本主税	固有一般
ちから	主税	固有人名
ふじもとのりあき	藤本憲明	固有一般
ふじもとゆうや	藤本裕也	固有一般
ふじもとよしき	藤本佳希	固有一般
よしき	佳希	固有人名
ふじもとれおん	藤本零音	固有一般
れおん	零音	固有人名
ふじもりりょうじ	藤森亮志	固有一般
りょうじ	亮志	固有人名
ふじやまともふみ	藤山智史	固有一般
ともふみ	智史	固有人名
ふじやまりゅうじ	藤山竜仁	固有一般
りゅうじ	竜仁	固有人名
ふじよしかいじろう	藤吉皆二朗	固有一般
かいじろう	皆二朗	固有人名
ふじよししんじ	藤吉信次	固有一般
ふじわらいっと	藤原一途	固有一般
いっと	一途	固有人名
ふじわらけんすけ	藤原健介	固有一般
ふじわらこうたろう	藤原広太朗	固有一般
こうたろう	広太朗	固有人名
ふじわらしりゅう	藤原志龍	固有一般
しりゅう	志龍	固有人名
ふじわらそうや	藤原奏哉	固有一般
そうや	奏哉	固有人名
ふじわらたくや	藤原拓也	固有一般
ふじわらとわ	藤原十和	固有一般
とわ	十和	固有人名
ふじわらまさと	藤原雅斗	固有一般
まさと	雅斗	固有人名
ふじわらゆうし	藤原優志	固有一般
ふじわらゆうだい	藤原優大	固有一般
ふせやしょう	布施谷翔	固有一般
ふたかわたかひろ	二川孝広	固有一般
たかひろ	孝広	固有人名
ふたみひろし	二見宏志	固有一般
ひろし	宏志	固有人名
ふつきしゅんのすけ	夫津木駿之介	固有一般
しゅんのすけ	駿之介	固有人名
ふとりよういち	太洋一	固有一般
ふなかわこうしろう	船川航司朗	固有一般
こうしろう	航司朗	固有人名
ふなかわたくのすけ	船川琢之介	固有一般
たくのすけ	琢之介	固有人名
ふなきかける	舩木翔	固有一般
ふなきだいすけ	舩木大輔	固有一般
ふなこしひろむ	船越大夢	固有一般
ふなこしゆうぞう	船越優蔵	固有一般
ゆうぞう	優蔵	固有人名
ふなたにけいすけ	船谷圭祐	固有一般
ふなつてつや	舩津徹也	固有一般
ふなつゆうや	船津佑也	固有一般
ふなはしきょうた	舩橋京汰	固有一般
きょうた	京汰	固有人名
ふなばしゆう	船橋 佑	固有一般
ふなばしゆうま	船橋勇真	固有一般
ふなやまたかゆき	船山貴之	固有一般
ふなやまゆうじ	船山祐二	固有一般
ふるおかゆうと	古岡佑斗	固有一般
ふるかわかいと	古川海光	固有一般
かいと	海光	固有人名
ふるかわがく	古川雅矩	固有一般
がく	雅矩	固有人名
ふるかわたくし	古川隆志	固有一般
たくし	隆志	固有人名
ふるかわだいご	古川大悟	固有一般
ふるかわつよし	古川毅	固有一般
ふるかわのぶひさ	古川頌久	固有一般
のぶひさ	頌久	固有人名
ふるかわまさあき	古川昌明	固有一般
ふるかわまさと	古川雅人	固有一般
ふるかわようすけ	古川陽介	固有一般
ふるがきふま	古垣風舞	固有一般
ふま	風舞	固有人名
ふるさわけいた	古澤慶太	固有一般
ふるしまきよと	古島清人	固有一般
きよと	清人	固有人名
ふるしまけいと	古島圭人	固有一般
けいと	圭人	固有人名
ふるたたいじ	古田泰士	固有一般
たいじ	泰士	固有人名
ふるたとうや	古田東也	固有一般
とうや	東也	固有人名
ふるたひろゆき	古田寛幸	固有一般
ひろゆき	寛幸	固有人名
ふるたによたろう	古谷陽太郎	固有一般
よたろう	陽太郎	固有人名
ふるはしきょうご	古橋亨梧	固有一般
きょうご	亨梧	固有人名
ふるはしたつや	古橋達弥	固有一般
ふるべけんた	古部健太	固有一般
ふるべよしのり	古邊芳昇	固有一般
よしのり	芳昇	固有人名
ふるやそま	古屋颯眞	固有一般
そま	颯眞	固有人名
ふるやまさき	古谷真基	固有一般
まさき	真基	固有人名
ふるやゆうほ	古屋雄帆	固有一般
ゆうほ	雄帆	固有人名
ふるやりくと	古谷陸翔	固有一般
ふるやどりく	古宿理久	固有一般
ふるやまけんご	古山兼悟	固有一般
けんご	兼悟	固有人名
ふるやまれん	古山蓮	固有一般
ぶらうんのあけんしん	ブラウンノア賢信	固有一般
ぶわにかけいた	ブワニカ啓太	固有一般
べくせうんどん	白 星東	固有一般
ほうしとまさひろ	法師人将大	固有一般
ほうじょうしんた	北條真汰	固有一般
しんた	真汰	固有人名
ほうじょうだいち	北條大地	固有一般
ほうじょうまさと	北条真智	固有一般
まさと	真智	固有人名
ほうのうたくと	宝納拓斗	固有一般
ほしとしんや	寶示戸進哉	固有一般
しんや	進哉	固有人名
ほかゆうへい	外悠平	固有一般
ほさかかずなり	保坂一成	固有一般
ほさかのぶゆき	保坂信之	固有一般
のぶゆき	信之	固有人名
ほざきすなお	保﨑淳	固有一般
ほしきょーわぁん	星キョーワァン	固有一般
きょーわぁん	キョーワァン	固有人名
ほしこうた	星広太	固有一般
ほしだいすけ	星大輔	固有一般
ほしゆうじ	星雄次	固有一般
ゆうじ	雄次	固有人名
ほしとなる	星戸成	固有一般
なる	成	固有人名
ほしのきょう	星野杏	固有一般
きょう	杏	固有人名
ほしのけいすけ	星野圭佑	固有一般
ほしのさとる	星野悟	固有一般
ほしのしんご	星野真悟	固有一般
しんご	真悟	固有人名
ほしのしんご	星野晋吾	固有一般
しんご	晋吾	固有人名
ほしのゆうすけ	星野有亮	固有一般
ゆうすけ	有亮	固有人名
ほしはらけんた	星原健太	固有一般
ほそかわかえで	細川楓	固有一般
ほそかわこうぞう	細川浩三	固有一般
こうぞう	浩三	固有人名
ほそかわじゅんや	細川淳矢	固有一般
ほそがいはじめ	細貝萌	固有一般
はじめ	萌	固有人名
ほそだあゆむ	細田歩夢	固有一般
ほそだかいと	細田海斗	固有一般
ほそだゆうき	細田裕葵	固有一般
ゆうき	裕葵	固有人名
ほそやけいご	細谷圭吾	固有一般
ほそやこうへい	細谷航平	固有一般
ほそやまお	細谷真大	固有一般
まお	真大	固有人名
ほそやゆいと	細谷唯斗	固有一般
ほったしゅうへい	堀田秀平	固有一般
ほっただいき	堀田大暉	固有一般
ほずみこうた	穂積滉太	固有一般
ほずみりょう	穂積諒	固有一般
ほりいぶき	堀伊吹	固有一般
ほりかいと	堀海斗	固有一般
ほりけんた	堀研太	固有一般
ほりけんと	堀健人	固有一般
ほりこうき	堀航輝	固有一般
ほりしゅうと	堀脩大	固有一般
しゅうと	脩大	固有人名
ほりたかふみ	堀孝史	固有一般
たかふみ	孝史	固有人名
ほりともき	堀友希	固有一般
ほりなおと	堀直人	固有一般
ほりいがくや	堀井岳也	固有一般
がくや	岳也	固有人名
ほりいけたくみ	堀池巧	固有一般
ほりいけひろみつ	堀池洋充	固有一般
ひろみつ	洋充	固有人名
ほりうちはやと	堀内颯人	固有一般
ほりうちようた	堀内陽太	固有一般
ほりえたかひろ	堀江貴大	固有一般
ほりえひびき	堀江響希	固有一般
ひびき	響希	固有人名
ほりかねしゅんめい	堀金峻明	固有一般
しゅんめい	峻明	固有人名
ほりかわとしひろ	堀河俊大	固有一般
としひろ	俊大	固有人名
ほりぐちこうへい	堀口皓平	固有一般
こうへい	皓平	固有人名
ほりぐちゆうと	堀口優人	固有一般
ほりこめはると	堀米遥斗	固有一般
ほりごめゆうき	堀米勇輝	固有一般
ほりごめゆうと	堀米悠斗	固有一般
ほりのうちさとし	堀之内聖	固有一般
さとし	聖	固有人名
ほんみょうぼ	洪明甫	固有一般
みょうぼ	明甫	固有人名
ほんじょうりゅうた	本庄竜大	固有一般
りゅうた	竜大	固有人名
ほんだかずま	本田一真	固有一般
ほんだけいすけ	本田圭佑	固有一般
ほんだこうき	本田功輝	固有一般
ほんだこうせい	本田硬靖	固有一般
こうせい	硬靖	固有人名
ほんだこうたろう	本多康太郎	固有一般
こうたろう	康太郎	固有人名
ほんだしんご	本田真吾	固有一般
ほんだせいじ	本田征治	固有一般
せいじ	征治	固有人名
ほんだたくと	本多琢人	固有一般
たくと	琢人	固有人名
ほんだたくや	本田拓也	固有一般
ほんだつよし	本多剛	固有一般
ほんだふうち	本田風智	固有一般
ふうち	風智	固有人名
ほんだまさや	本田将也	固有一般
ほんだやすと	本田泰人	固有一般
やすと	泰人	固有人名
ほんだゆうき	本多勇喜	固有一般
ゆうき	勇喜	固有人名
ほんだよしき	本多慶貴	固有一般
よしき	慶貴	固有人名
ほんなみけんじ	本並健治	固有一般
けんじ	健治	固有人名
ほんまいさお	本間勲	固有一般
いさお	勲	固有人名
ほんまこうじ	本間幸司	固有一般
ほんましおん	本間至恩	固有一般
しおん	至恩	固有人名
ほんまじゃすてぃん	本間ジャスティン	固有一般
じゃすてぃん	ジャスティン	固有人名
ほんまはると	本間温士	固有一般
はると	温士	固有人名
ほんまゆうすけ	本間佑允	固有一般
ゆうすけ	佑允	固有人名
ほんまようへい	本間洋平	固有一般
ほんまちなおき	本街直樹	固有一般
ほんみょうとしき	本明利樹	固有一般
ほんむらたけあき	本村武揚	固有一般
たけあき	武揚	固有人名
まいえひでたか	真家英嵩	固有一般
ひでたか	英嵩	固有人名
まいくませいや	毎熊晟矢	固有一般
せいや	晟矢	固有人名
まいけんろんじぇーむず	舞行龍 ジェームズ	固有一般
まえたかゆき	前貴之	固有一般
まえひろゆき	前寛之	固有一般
まえかわかずや	前川和也	固有一般
まえかわしゅうと	前川修音	固有一般
しゅうと	修音	固有人名
まえかわたいが	前川大河	固有一般
まえかわだいや	前川黛也	固有一般
だいや	黛也	固有人名
まえかわともゆき	前川智敬	固有一般
ともゆき	智敬	固有人名
まえかわれん	前川廉	固有一般
ますがわまさゆき	前川正行	固有一般
まえざとゆうき	前里裕希	固有一般
まえざわこうき	前澤甲気	固有一般
こうき	甲気	固有人名
まえしろけんや	真栄城兼哉	固有一般
けんや	兼哉	固有人名
まえじまようた	前嶋洋太	固有一般
まえぞのまさきよ	前園真聖	固有一般
まえだいちか	前田一翔	固有一般
いちか	一翔	固有人名
まえだおさむ	前田治	固有一般
まえだかずや	前田和哉	固有一般
まえだかずや	前田和也	固有一般
まえだこういち	前田晃一	固有一般
まえだこうじ	前田浩二	固有一般
まえだしゅう	前田柊	固有一般
しゅう	柊	固有人名
まえだしゅんすけ	前田俊介	固有一般
まえだしょうま	前田翔茉	固有一般
しょうま	翔茉	固有人名
まえだたいら	前田泰良	固有一般
たいら	泰良	固有人名
まえだたかし	前田隆	固有一般
たかし	隆	固有人名
まえだだいぜん	前田大然	固有一般
だいぜん	大然	固有人名
まえだなおき	前田直輝	固有一般
まえだなおき	前田尚輝	固有一般
まえだのぶひろ	前田信弘	固有一般
のぶひろ	信弘	固有人名
まえだひろき	前田紘基	固有一般
ひろき	紘基	固有人名
まえだひろき	前田央樹	固有一般
まえだまさふみ	前田雅文	固有一般
まさふみ	雅文	固有人名
まえだゆうすけ	前田悠佑	固有一般
まえだゆうと	前田悠斗	固有一般
まえだよしき	前田義貴	固有一般
まえだりゅうだい	前田龍大	固有一般
りゅうだい	龍大	固有人名
まえだりょういち	前田遼一	固有一般
まえだりょうすけ	前田凌佑	固有一般
りょうすけ	凌佑	固有人名
まえだりょうすけ	前田椋介	固有一般
りょうすけ	椋介	固有人名
まえのたかのり	前野貴徳	固有一般
たかのり	貴徳	固有人名
まえむらしょう	前村翔	固有一般
まえやまきょうへい	前山恭平	固有一般
まがりやましゅうと	曲山蹴斗	固有一般
しゅうと	蹴斗	固有人名
まきこうへい	真木晃平	固有一般
まきせいいちろう	巻誠一郎	固有一般
まきゆうき	巻佑樹	固有一般
まきうちけいた	牧内慶太	固有一般
まきぐちかずま	牧口一真	固有一般
まきしまはあと	牧嶋波亜斗	固有一般
はあと	波亜斗	固有人名
まきたせいいち	巻田清一	固有一般
せいいち	清一	固有人名
まきたてっぺい	蒔田哲平	固有一般
まきたりくと	蒔田陸斗	固有一般
まきのかんた	牧野寛太	固有一般
まきのけいすけ	牧野景輔	固有一般
けいすけ	景輔	固有人名
まきのさとる	牧野悟	固有一般
まきのしんじ	牧野真二	固有一般
まきのともあき	槙野智章	固有一般
ともあき	智章	固有人名
まきのともや	牧野友哉	固有一般
まきのなおき	牧野直樹	固有一般
まきやまこうせい	牧山晃政	固有一般
こうせい	晃政	固有人名
まごひでのり	真子秀徳	固有一般
ひでのり	秀徳	固有人名
ましまゆうや	間嶋佑弥	固有一般
ますびもてし	真下佐登史	固有一般
もてし	佐登史	固有人名
ますいけん	倍井謙	固有一般
けん	謙	固有人名
ますいてっぺい	増井哲平	固有一般
ますおかえいき	升岡栄喜	固有一般
えいき	栄喜	固有人名
ますかけゆうご	升掛友護	固有一般
ゆうご	友護	固有人名
ますかわたかひろ	増川隆洋	固有一般
たかひろ	隆洋	固有人名
ますこよしひろ	益子義浩	固有一般
よしひろ	義浩	固有人名
ますざきだいご	増崎大虎	固有一般
だいご	大虎	固有人名
ますしまたつや	増嶋竜也	固有一般
ますたにこうすけ	増谷幸祐	固有一般
こうすけ	幸祐	固有人名
ますたにたから	桝谷岳良	固有一般
たから	岳良	固有人名
ますだおういち	益田欧一	固有一般
おういち	欧一	固有人名
ますだけんしょう	増田健昇	固有一般
けんしょう	健昇	固有人名
ますだこうさく	増田功作	固有一般
こうさく	功作	固有人名
ますだしげと	増田繁人	固有一般
しげと	繁人	固有人名
ますだしゅんじ	増田隼司	固有一般
しゅんじ	隼司	固有人名
ますだたくや	増田卓也	固有一般
ますだただとし	増田忠俊	固有一般
ただとし	忠俊	固有人名
ますだちかし	増田誓志	固有一般
ちかし	誓志	固有人名
ますだはると	増田開登	固有一般
はると	開登	固有人名
ますだゆうたろう	桝田雄太郎	固有一般
ますだりょうが	桝田凌我	固有一般
ますむらかずき	増村風月	固有一般
かずき	風月	固有人名
ますもりしょうご	増森正悟	固有一般
しょうご	正悟	固有人名
ますやまあさひ	増山朝陽	固有一般
あさひ	朝陽	固有人名
ますやまつかさ	益山司	固有一般
ませたくみ	真瀬拓海	固有一般
まちだこうき	町田浩樹	固有一般
こうき	浩樹	固有人名
まちだただみち	町田忠道	固有一般
ただみち	忠道	固有人名
まちだたもん	町田多聞	固有一般
たもん	多聞	固有人名
まちだぶらいと	町田ブライト	固有一般
ぶらいと	ブライト	固有人名
まちだやまと	町田也真人	固有一般
やまと	也真人	固有人名
まちだらんじろう	町田蘭次郎	固有一般
らんじろう	蘭次郎	固有人名
まちのしゅうと	町野修斗	固有一般
しゅうと	修斗	固有人名
まついけんや	松井謙弥	固有一般
けんや	謙弥	固有人名
まついこうすけ	松井康輔	固有一般
まついだいすけ	松井大輔	固有一般
まついはるき	松井治輝	固有一般
はるき	治輝	固有人名
まついりつき	松井陸希	固有一般
りつき	陸希	固有人名
まついれんじ	松井蓮之	固有一般
れんじ	蓮之	固有人名
まつうらあつし	松浦敦史	固有一般
まつうらあつし	松浦淳	固有一般
まつうらいさむ	松浦勇武	固有一般
いさむ	勇武	固有人名
まつうらこうじ	松浦宏治	固有一般
こうじ	宏治	固有人名
まつうらこうよう	松浦航洋	固有一般
まつうらしょうたろう	松浦祥太郎	固有一般
まつうらたくや	松浦拓弥	固有一般
まつうらなおと	松浦尚人	固有一般
なおと	尚人	固有人名
まつうらひであき	松裏英明	固有一般
まつうらひろむ	松浦大武	固有一般
ひろむ	大武	固有人名
まつおあつし	松尾篤	固有一般
まつおきら	松尾光羅	固有一般
きら	光羅	固有人名
まつおけんた	松尾健太	固有一般
まつおしょうご	松尾昇悟	固有一般
まつおなおと	松尾直人	固有一般
まつおゆういち	松尾侑一	固有一般
ゆういち	侑一	固有人名
まつおゆうすけ	松尾勇佑	固有一般
ゆうすけ	勇佑	固有人名
まつおゆうすけ	松尾佑介	固有一般
まつおかこうや	松岡昂哉	固有一般
こうや	昂哉	固有人名
まつおかしょうた	松岡翔太	固有一般
まつおかじょなたん	松岡ジョナタン	固有一般
じょなたん	ジョナタン	固有人名
まつおかだいき	松岡大起	固有一般
だいき	大起	固有人名
まつおかだいち	松岡大智	固有一般
まつおかはやと	松岡颯人	固有一般
まつおかやすのぶ	松岡康暢	固有一般
やすのぶ	康暢	固有人名
まつおかよしひこ	松岡良彦	固有一般
よしひこ	良彦	固有人名
まつおかるむ	松岡瑠夢	固有一般
るむ	瑠夢	固有人名
まつおかりょうすけ	松岡亮輔	固有一般
まつかわともあき	松川友明	固有一般
まつきくりゅう	松木玖生	固有一般
くりゅう	玖生	固有人名
まつきしゅんのすけ	松木駿之介	固有一般
まつきせいや	松木政也	固有一般
せいや	政也	固有人名
まつくぼたくと	松久保拓斗	固有一般
まつくまひなた	松隈日向太	固有一般
ひなた	日向太	固有人名
まつざかだにぇるるいす	松坂暖	固有一般
まつざきかい	松崎快	固有一般
まつざわあきら	松澤彰	固有一般
まつざわかいと	松澤海斗	固有一般
まつざわこうき	松澤香輝	固有一般
こうき	香輝	固有人名
まつざわはやと	松澤隼人	固有一般
まつしたかずま	松下和磨	固有一般
まつしたこうへい	松下幸平	固有一般
まつしたじゅんと	松下純土	固有一般
じゅんと	純土	固有人名
まつしただいすけ	松下太輔	固有一般
だいすけ	太輔	固有人名
まつしたとしひろ	松下年宏	固有一般
まつしたなおき	松下直樹	固有一般
まつしたゆうき	松下裕樹	固有一般
まつしたよしき	松下佳貴	固有一般
よしき	佳貴	固有人名
まつしたやすし	松下泰士	固有一般
やすし	泰士	固有人名
まつしまこうせい	松嶋好誠	固有一般
こうせい	好誠	固有人名
まつしまひとし	松島仁	固有一般
まつだえいたろう	松田詠太郎	固有一般
えいたろう	詠太郎	固有人名
まつだかずや	松田和也	固有一般
まつだけいた	松田佳大	固有一般
まつだけんた	松田賢太	固有一般
けんた	賢太	固有人名
まつだこうすけ	松田康佑	固有一般
こうすけ	康佑	固有人名
まつだつとむ	松田勉	固有一般
まつだてんま	松田天馬	固有一般
てんま	天馬	固有人名
まつだとのま	松田飛乃舞	固有一般
とのま	飛乃舞	固有人名
まつだなおき	松田直樹	固有一般
まつだはやて	松田隼風	固有一般
はやて	隼風	固有人名
まつだはるふみ	松田春文	固有一般
はるふみ	春文	固有人名
まつだひでき	松田英樹	固有一般
まつだひろし	松田浩	固有一般
まつだまさとし	松田正俊	固有一般
まつだゆうすけ	松田悠佑	固有一般
まつだよしのり	松田考功	固有一般
よしのり	考功	固有人名
まつだりき	松田力	固有一般
まつだりく	松田陸	固有一般
まつながかいと	松永海斗	固有一般
まつながかずよし	松永一慶	固有一般
かずよし	一慶	固有人名
まつながしげたつ	松永成立	固有一般
しげたつ	成立	固有人名
まつながしょうへい	松永祥兵	固有一般
しょうへい	祥兵	固有人名
まつながねゆうと	松長根悠仁	固有一般
まつなみまさのぶ	松波正信	固有一般
まさのぶ	正信	固有人名
まつはししょうた	松橋章太	固有一般
まつはしまさる	松橋優	固有一般
まさる	優	固有人名
まつはしゆあん	松橋優安	固有一般
ゆあん	優安	固有人名
まつはしりきぞう	松橋力蔵	固有一般
りきぞう	力蔵	固有人名
まつばらかいせい	松原快晟	固有一般
かいせい	快晟	固有人名
まつばらけん	松原健	固有一般
まつばらこう	松原后	固有一般
こう	后	固有人名
まつばらこうき	松原亘紀	固有一般
こうき	亘紀	固有人名
まつばらしゅうへい	松原修平	固有一般
まつばらしゅうも	松原秀模	固有一般
しゅうも	秀模	固有人名
まつばらしょうた	松原翔太	固有一般
まつばらそうた	松原颯汰	固有一般
まつばらたいが	松原大芽	固有一般
たいが	大芽	固有人名
まつばらただあき	松原忠明	固有一般
ただあき	忠明	固有人名
まつばらだいき	松原大貴	固有一般
まつばらひろき	松原浩樹	固有一般
ひろき	浩樹	固有人名
まつばらゆうき	松原優吉	固有一般
ゆうき	優吉	固有人名
まつばらよしか	松原良香	固有一般
よしか	良香	固有人名
まつばられん	松原蓮	固有一般
まつふじまさのぶ	松藤正伸	固有一般
まさのぶ	正伸	固有人名
まつむらこうき	松村航希	固有一般
まつむらこうすけ	松村晃助	固有一般
こうすけ	晃助	固有人名
まつむらしゅんすけ	松村駿佑	固有一般
まつむらせれ	松村晟怜	固有一般
せれ	晟怜	固有人名
まつむらはると	松村遥人	固有一般
まつむらゆうた	松村優太	固有一般
まつむらゆり	松村祐吏	固有一般
ゆり	祐吏	固有人名
まつむらりょう	松村亮	固有一般
まつもとあいき	松本愛己	固有一般
あいき	愛己	固有人名
まつもとあゆむ	松本歩夢	固有一般
まつもとかんた	松本幹太	固有一般
まつもとけいすけ	松本圭介	固有一般
まつもとけん	松本憲	固有一般
まつもとけんちざんが	松本ケンチザンガ	固有一般
まつもとけんた	松本健太	固有一般
まつもとけんたろう	松本健太郎	固有一般
まつもとこうせい	松本皐誠	固有一般
こうせい	皐誠	固有人名
まつもとこうへい	松本孝平	固有一般
こうへい	孝平	固有人名
まつもとしょう	松本翔	固有一般
まつもとたいし	松本泰志	固有一般
たいし	泰志	固有人名
まつもとたいち	松本太一	固有一般
まつもとたかとし	松本昂聡	固有一般
たかとし	昂聡	固有人名
まつもとたくや	松本拓也	固有一般
まつもとだいき	松本大輝	固有一般
まつもとだいじゅ	松本大樹	固有一般
まつもとだいすけ	松本大輔	固有一般
まつもとなおや	松本直也	固有一般
まつもとなぎ	松本凪生	固有一般
なぎ	凪生	固有人名
まつもとはると	松本遥翔	固有一般
まつもとひろや	松本大弥	固有一般
ひろや	大弥	固有人名
まつもとひろゆき	松本浩幸	固有一般
ひろゆき	浩幸	固有人名
まつもとまさや	松本昌也	固有一般
まつもとやすし	松本安司	固有一般
やすし	安司	固有人名
まつもとゆうき	松本祐樹	固有一般
まつもとゆうま	松本雄真	固有一般
ゆうま	雄真	固有人名
まつもとようすけ	松本陽介	固有一般
まつもとりく	松本陸	固有一般
まつもとれお	松本怜大	固有一般
れお	怜大	固有人名
まつもとれい	松本怜	固有一般
まつもとれん	松本蓮	固有一般
まつやまけんた	松山健太	固有一般
まつやまだいち	松山大地	固有一般
まつやまひろあき	松山博明	固有一般
ひろあき	博明	固有人名
まつやまよしゆき	松山吉之	固有一般
よしゆき	吉之	固有人名
まつよなおき	松代直樹	固有一般
またなかしゅうば	眞中脩羽	固有一般
しゅうば	脩羽	固有人名
またなかひろと	眞中裕都	固有一般
ひろと	裕都	固有人名
またなかみきお	眞中幹夫	固有一般
みきお	幹夫	固有人名
またなかやすお	眞中靖夫	固有一般
やすお	靖夫	固有人名
まなべはやと	真鍋隼虎	固有一般
はやと	隼虎	固有人名
まなべひかる	眞鍋旭輝	固有一般
ひかる	旭輝	固有人名
まなべひかる	真鍋光	固有一般
まのりょうじ	真野亮二	固有一般
りょうじ	亮二	固有人名
まるおかさとる	丸岡悟	固有一般
まるおかみつる	丸岡満	固有一般
まるたにたくや	丸谷拓也	固有一般
まるはしゆうすけ	丸橋祐介	固有一般
まるもとゆうへい	丸本侑平	固有一般
ゆうへい	侑平	固有人名
まるやまきら	丸山貴羅	固有一般
きら	貴羅	固有人名
まるやまこうき	丸山皓己	固有一般
まるやましゅうと	丸山嵩大	固有一般
しゅうと	嵩大	固有人名
まるやまそうた	丸山壮大	固有一般
そうた	壮大	固有人名
まるやまゆういち	丸山祐市	固有一般
ゆういち	祐市	固有人名
まるやまゆうたろう	丸山優太朗	固有一般
まるやまよしあき	丸山良明	固有一般
よしあき	良明	固有人名
まわたりかずあき	馬渡和彰	固有一般
かずあき	和彰	固有人名
まわたりじゅんき	馬渡隼暉	固有一般
じゅんき	隼暉	固有人名
まわたりひろき	馬渡洋樹	固有一般
ひろき	洋樹	固有人名
まんしょみつる	満生充	固有一般
みうらあきと	三浦旭人	固有一般
あきと	旭人	固有人名
みうらあつひろ	三浦淳宏	固有一般
あつひろ	淳宏	固有人名
みうらおさむ	三浦修	固有一般
みうらかずよし	三浦知良	固有一般
かずよし	知良	固有人名
みうらげんた	三浦弦太	固有一般
げんた	弦太	固有人名
みうらこうき	三浦康希	固有一般
こうき	康希	固有人名
みうらごうた	三浦豪太	固有一般
ごうた	豪太	固有人名
みうらしゅんた	三浦隼太	固有一般
しゅんた	隼太	固有人名
みうらそうた	三浦颯太	固有一般
みうらとしくに	三浦敏邦	固有一般
としくに	敏邦	固有人名
みうらふみたけ	三浦文丈	固有一般
ふみたけ	文丈	固有人名
みうらもとあき	三浦基瑛	固有一般
もとあき	基瑛	固有人名
みうらやすとし	三浦泰年	固有一般
やすとし	泰年	固有人名
みうらゆうすけ	三浦雄介	固有一般
みうらゆうと	三浦悠斗	固有一般
みうらゆうや	三浦雄也	固有一般
みうらりゅうき	三浦龍輝	固有一般
りゅうき	龍輝	固有人名
みおあつし	美尾敦	固有一般
あつし	敦	固有人名
みかどゆうた	三門雄大	固有一般
みかみあきのり	三上明紀	固有一般
あきのり	明紀	固有人名
みかみかずよし	三上和良	固有一般
かずよし	和良	固有人名
みかみたくや	三上卓哉	固有一般
みかみようすけ	三上陽輔	固有一般
ようすけ	陽輔	固有人名
みかもとうあ	美甘仁愛	固有一般
とうあ	仁愛	固有人名
みきかい	三鬼海	固有一般
みきたかし	三木隆司	固有一般
みきともや	見木友哉	固有一般
みきなおと	三木直土	固有一般
なおと	直土	固有人名
みきりょうた	三木良太	固有一般
みきぶいとる	三木ヴィトル	固有一般
ぶいとる	ヴィトル	固有人名
みぎたかえで	右田楓	固有一般
みくにけねでぃえぶす	三國ケネディエブス	固有一般
けねでぃえぶす	ケネディエブス	固有人名
みくにすてぃびあえぶす	三國スティビアエブス	固有一般
すてぃびあえぶす	スティビアエブス	固有人名
みくりやけい	御厨景	固有一般
けい	景	固有人名
みくりやたかふみ	御厨貴文	固有一般
みさおけんと	三竿健斗	固有一般
みさおゆうと	三竿雄斗	固有一般
みさきみつひろ	見崎充洋	固有一般
みつひろ	充洋	固有人名
みさだせいた	美佐田誠大	固有一般
せいた	誠大	固有人名
みさわけいいち	三澤慶一	固有一般
けいいち	慶一	固有人名
みさわじゅんいち	三澤純一	固有一般
みさわたくほ	見澤拓歩	固有一般
たくほ	拓歩	固有人名
みさわなおと	三沢直人	固有一般
みしまこうへい	三島康平	固有一般
みしましょうへい	三島頌平	固有一般
しょうへい	頌平	固有人名
みしまゆうた	三島勇太	固有一般
みしろときとら	三城怜虎	固有一般
ときとら	怜虎	固有人名
みずうちたけし	水内猛	固有一般
たけし	猛	固有人名
みずかみしゅり	水上珠吏	固有一般
しゅり	珠吏	固有人名
みずきこうせい	水木康誠	固有一般
こうせい	康誠	固有人名
みずきまさと	水木将人	固有一般
まさと	将人	固有人名
みずきゆうふみ	水筑優文	固有一般
ゆうふみ	優文	固有人名
みずくらけい	水倉慧	固有一般
みずぐちひろ	水口飛呂	固有一般
ひろ	飛呂	固有人名
みずぐちゆうと	水口由翔	固有一般
ゆうと	由翔	固有人名
みずこしじゅん	水越潤	固有一般
みずさきやすし	水崎靖	固有一般
みずさわしゅんた	水沢俊太	固有一般
みずたゆうま	水田雄真	固有一般
みずたにあゆむ	水谷歩夢	固有一般
みずたにたくま	水谷拓磨	固有一般
みずたにまさとし	水谷允俊	固有一般
まさとし	允俊	固有人名
みずたにゆういち	水谷雄一	固有一般
みずたにゆうや	水谷友哉	固有一般
ゆうや	友哉	固有人名
みずながしょうま	水永翔馬	固有一般
しょうま	翔馬	固有人名
みずぬまこうた	水沼宏太	固有一般
みずぬまたかし	水沼貴史	固有一般
みずのこうき	水野晃樹	固有一般
こうき	晃樹	固有人名
みずのじゅん	水野淳	固有一般
みずのたいすけ	水野泰輔	固有一般
たいすけ	泰輔	固有人名
みずのともひろ	水野智大	固有一般
みずのはやた	水野颯太	固有一般
みずのひかる	水野輝	固有一般
みずはらひろき	水原大樹	固有一般
みずもとかつなり	水本勝成	固有一般
かつなり	勝成	固有人名
みずもとひろき	水本裕貴	固有一般
みぞうえけいすけ	溝上敬佑	固有一般
みぞぐちしゅうへい	溝口修平	固有一般
みぞぐちはるひ	溝口陽日	固有一般
はるひ	陽日	固有人名
みぞぶちゆうし	溝渕雄志	固有一般
みたひかる	三田光	固有一般
みたひさお	三田尚央	固有一般
ひさお	尚央	固有人名
みたひろたか	三田啓貴	固有一般
ひろたか	啓貴	固有人名
みたまさゆき	見田雅之	固有一般
みちうえはやと	道上隼人	固有一般
みちきりゅうじ	路木龍次	固有一般
りゅうじ	龍次	固有人名
みちぶちりょうへい	道渕諒平	固有一般
りょうへい	諒平	固有人名
みちわきゆたか	道脇豊	固有一般
みついだいき	三井大輝	固有一般
みつおかしんや	光岡眞矢	固有一般
しんや	眞矢	固有人名
みつざきしん	光崎伸	固有一般
みつぞのしゅうたろう	満園修太郎	固有一般
しゅうたろう	修太郎	固有人名
みつたまこと	満田誠	固有一般
みつだはるき	三ッ田啓希	固有一般
はるき	啓希	固有人名
みつながたいせい	光永大晟	固有一般
みつながゆうや	光永祐也	固有一般
みつはししゅうへい	三橋秀平	固有一般
みつはしたくま	三橋拓真	固有一般
みつひらかずし	三平和司	固有一般
みつひろけんり	光廣健利	固有一般
けんり	健利	固有人名
みつふじかいせい	光藤海晴	固有一般
かいせい	海晴	固有人名
みつふじりょうや	光藤諒也	固有一般
みつまるひろむ	三丸拡	固有一般
ひろむ	拡	固有人名
みとしゅんすけ	三戸舜介	固有一般
しゅんすけ	舜介	固有人名
みとりん	美藤倫	固有一般
りん	倫	固有人名
みとべとうじ	水戸部東次	固有一般
とうじ	東次	固有人名
みとまかおる	三笘薫	固有一般
みながわしょうた	皆川翔太	固有一般
みながわゆうすけ	皆川佑介	固有一般
みなくちこうすけ	水口耕輔	固有一般
こうすけ	耕輔	固有人名
みなくちゆうと	水口湧斗	固有一般
みなみこうた	南光太	固有一般
みなみしゅうと	南秀仁	固有一般
みなみたくと	南拓都	固有一般
たくと	拓都	固有人名
みなみひろき	皆見宏樹	固有一般
みなみまなぶ	己浪学	固有一般
みなみゆうぞう	南祐三	固有一般
みなみゆうた	南雄太	固有一般
みなみりょうた	南稜大	固有一般
りょうた	稜大	固有人名
みなみのたくみ	南野拓実	固有一般
みなみのはるみ	南野遥海	固有一般
はるみ	遥海	固有人名
みなもとかつひろ	皆本勝弘	固有一般
かつひろ	勝弘	固有人名
みねかずき	三根和起	固有一般
かずき	和起	固有人名
みねはやと	峯勇斗	固有一般
みねぎしけいすけ	嶺岸佳介	固有一般
みねぎしりおん	嶺岸凛音	固有一般
りおん	凛音	固有人名
みのだこうだい	蓑田広大	固有一般
こうだい	広大	固有人名
みのべなおひこ	美濃部直彦	固有一般
みのわよしのぶ	箕輪義信	固有一般
よしのぶ	義信	固有人名
みはしたくや	三橋拓也	固有一般
みはらこうへい	三原向平	固有一般
こうへい	向平	固有人名
みはらしゅうま	三原秀真	固有一般
みはらたくや	三原拓也	固有一般
みはらなおき	三原直樹	固有一般
みはらひろき	三原廣樹	固有一般
ひろき	廣樹	固有人名
みはらひろゆき	三原大幸	固有一般
ひろゆき	大幸	固有人名
みはらまさとし	三原雅俊	固有一般
みふねこうせい	三舩煌晴	固有一般
こうせい	煌晴	固有人名
みまかずや	美馬和也	固有一般
みむらまこと	三村真	固有一般
みやだいき	宮大樹	固有一般
みやいちつよし	宮市剛	固有一般
みやいちりょう	宮市亮	固有一般
みやうちひろと	宮内寛斗	固有一般
みやうちゆうき	宮内雄希	固有一般
みやうちりゅうた	宮内龍汰	固有一般
りゅうた	龍汰	固有人名
みやおこういち	宮尾孝一	固有一般
みやかわだいすけ	宮川大輔	固有一般
みやがわさとし	宮川悟	固有一般
さとし	悟	固有人名
みやがわだいき	宮川大輝	固有一般
みやぎかずや	宮城和也	固有一般
みやぎこうた	宮城晃太	固有一般
みやぎてん	宮城天	固有一般
みやぎまさふみ	宮城雅史	固有一般
まさふみ	雅史	固有人名
みやくらじゅりあん	宮倉樹里杏	固有一般
じゅりあん	樹里杏	固有人名
みやけかいと	三宅海斗	固有一般
みやけたかのり	三宅貴憲	固有一般
たかのり	貴憲	固有人名
みやけひろき	三宅浩暉	固有一般
ひろき	浩暉	固有人名
みやけりゅうと	三宅龍人	固有一般
みやさかまさき	宮阪政樹	固有一般
まさき	政樹	固有人名
みやざきかいと	宮㟢海斗	固有一般
みやざききわら	宮崎幾笑	固有一般
きわら	幾笑	固有人名
みやざきけいしん	宮崎圭伸	固有一般
けいしん	圭伸	固有人名
みやざきけんじ	宮崎健治	固有一般
みやざきこう	宮崎鴻	固有一般
こう	鴻	固有人名
みやざきこうた	宮崎航汰	固有一般
みやざきこうへい	宮崎光平	固有一般
みやざきじゅんま	宮崎純真	固有一般
じゅんま	純真	固有人名
みやざきたいすけ	宮崎泰右	固有一般
たいすけ	泰右	固有人名
みやざきだいしろう	宮崎大志郎	固有一般
だいしろう	大志郎	固有人名
みやざきともひこ	宮崎智彦	固有一般
ともひこ	智彦	固有人名
みやざきひなた	宮崎陽	固有一般
みやざわかつゆき	宮沢克行	固有一般
かつゆき	克行	固有人名
みやざわつばさ	宮澤飛翔	固有一般
みやざわひろき	宮澤裕樹	固有一般
みやざわひろし	宮澤浩	固有一般
みやざわまさし	宮沢正史	固有一般
まさし	正史	固有人名
みやざわみっしぇる	宮澤ミッシェル	固有一般
みっしぇる	ミッシェル	固有人名
みやしたけいた	宮下渓太	固有一般
みやしたしゅうほ	宮下周歩	固有一般
しゅうほ	周歩	固有人名
みやしたはやと	宮下隼	固有一般
みやしたまさひろ	宮下真洋	固有一般
まさひろ	真洋	固有人名
みやしろたいせい	宮代大聖	固有一般
たいせい	大聖	固有人名
みやじようすけ	宮路洋輔	固有一般
みやじまだいき	宮嶋大輝	固有一般
みやじまゆう	宮島裕	固有一般
みやたいずみ	宮田和純	固有一般
いずみ	和純	固有人名
みやたけんたろう	宮田健太郎	固有一般
みやたなおき	宮田直樹	固有一般
みやたはる	宮田遥	固有一般
みやたりょうすけ	宮田涼介	固有一般
みやちげんき	宮地元貴	固有一般
げんき	元貴	固有人名
みやはらあいき	宮原愛輝	固有一般
あいき	愛輝	固有人名
みやはらかずや	宮原和也	固有一般
みやはらゆうじ	宮原裕司	固有一般
みやはらゆうた	宮原勇太	固有一般
みやべたいき	宮部大己	固有一般
たいき	大己	固有人名
みやむらまさし	宮村正志	固有一般
まさし	正志	固有人名
みやむらりく	宮村離玖	固有一般
りく	離玖	固有人名
みやもとあらた	宮本新	固有一般
みやもとあれん	宮本歩蓮	固有一般
あれん	歩蓮	固有人名
みやもといちたか	宮本一貴	固有一般
いちたか	一貴	固有人名
みやもとえいじ	宮本英治	固有一般
えいじ	英治	固有人名
みやもとこうた	宮本航汰	固有一般
みやもとたくみ	宮本拓海	固有一般
みやもとたくや	宮本卓也	固有一般
みやもとたくや	宮本拓弥	固有一般
みやもとつねやす	宮本恒靖	固有一般
つねやす	恒靖	固有人名
みやもとてつひろ	宮本哲宏	固有一般
てつひろ	哲宏	固有人名
みやもととおる	宮本亨	固有一般
とおる	亨	固有人名
みやもととしあき	宮本駿晃	固有一般
としあき	駿晃	固有人名
みやもとみきはる	宮本樹明	固有一般
みきはる	樹明	固有人名
みやもとゆう	宮本優	固有一般
みやもとゆうた	宮本優太	固有一般
みやもとゆきあ	宮本幸亜	固有一般
ゆきあ	幸亜	固有人名
みやもとらいや	宮本頼哉	固有一般
らいや	頼哉	固有人名
みやもとりゅう	宮本龍	固有一般
りゅう	龍	固有人名
みやもとるい	宮本流維	固有一般
るい	流維	固有人名
みやよしたくみ	宮吉拓実	固有一般
みやわきけんた	宮脇健太	固有一般
みやわきしげお	宮脇茂夫	固有一般
しげお	茂夫	固有人名
みゆきひでとし	三幸秀稔	固有一般
ひでとし	秀稔	固有人名
みょがんとや	名願斗哉	固有一般
とや	斗哉	固有人名
みょうじんともかず	明神智和	固有一般
みょうどうかずや	明堂和也	固有一般
みよしきよたか	三吉聖王	固有一般
きよたか	聖王	固有人名
みよしこうじ	三好康児	固有一般
こうじ	康児	固有人名
みよししゅうと	三好崇斗	固有一般
しゅうと	崇斗	固有人名
みよしたくじ	三好拓児	固有一般
たくじ	拓児	固有人名
みよしひろちか	三好洋央	固有一般
ひろちか	洋央	固有人名
むかいあきと	向井章人	固有一般
あきと	章人	固有人名
むかいしんいち	向慎一	固有一般
むかいはやて	向井颯	固有一般
むぎくらなつき	麦倉捺木	固有一般
なつき	捺木	固有人名
むぎたかずゆき	麦田和志	固有一般
かずゆき	和志	固有人名
むくけんた	椋健太	固有一般
むくはらけんた	椋原健太	固有一般
むぐるまたくや	六車拓也	固有一般
むこがわたかと	向川空斗	固有一般
たかと	空斗	固有人名
むこじまたつる	向島建	固有一般
たつる	建	固有人名
むこじまみつる	向島満	固有一般
むさかみつなり	六平光成	固有一般
みつなり	光成	固有人名
むしゃひろむ	武者大夢	固有一般
むたゆうすけ	牟田雄祐	固有一般
むとうしんいち	武藤真一	固有一般
むとうゆうき	武藤友樹	固有一般
ゆうき	友樹	固有人名
むとうゆうき	武藤雄樹	固有一般
むとうよしのり	武藤嘉紀	固有一般
よしのり	嘉紀	固有人名
むなかたひろふみ	棟方博文	固有一般
ひろふみ	博文	固有人名
むねちかけい	宗近慧	固有一般
むらいしんじ	村井慎二	固有一般
しんじ	慎二	固有人名
むらいせいた	村井清太	固有一般
せいた	清太	固有人名
むらいせいた	村井清大	固有一般
せいた	清大	固有人名
むらいたいき	村井泰希	固有一般
たいき	泰希	固有人名
むらおたつや	村尾龍矢	固有一般
たつや	龍矢	固有人名
むらおかたくや	村岡拓哉	固有一般
むらかみかずき	村上一樹	固有一般
むらかみかずひろ	村上和弘	固有一般
むらかみきっぺい	村上桔平	固有一般
きっぺい	桔平	固有人名
むらかみけいし	村上景司	固有一般
けいし	景司	固有人名
むらかみせいや	村上聖弥	固有一般
せいや	聖弥	固有人名
むらかみたくみ	村上巧	固有一般
むらかみたつき	村上竜規	固有一般
たつき	竜規	固有人名
むらかみまさあき	村上昌謙	固有一般
まさあき	昌謙	固有人名
むらかみゆうすけ	村上佑介	固有一般
むらかみゆうひ	村上悠緋	固有一般
ゆうひ	悠緋	固有人名
むらかみゆきと	村上千歩	固有一般
ゆきと	千歩	固有人名
むらきしんじ	村木伸二	固有一般
むらきひかる	村木輝	固有一般
むらこしかいが	村越凱光	固有一般
かいが	凱光	固有人名
むらしたしょうご	村下将梧	固有一般
むらせかずたか	村瀬和隆	固有一般
かずたか	和隆	固有人名
むらせしん	村瀬心	固有一般
むらせゆうすけ	村瀬悠介	固有一般
むらせゆうた	村瀬勇太	固有一般
むらたかずひろ	村田一弘	固有一般
かずひろ	一弘	固有人名
むらたかずや	村田和哉	固有一般
むらたこういち	村田航一	固有一般
こういち	航一	固有人名
むらたしょう	村田翔	固有一般
むらたたつや	村田達哉	固有一般
むらたとま	村田透馬	固有一般
とま	透馬	固有人名
むらたのりお	村田教生	固有一般
のりお	教生	固有人名
むらたまさき	村田聖樹	固有一般
まさき	聖樹	固有人名
むらなかそういちろう	村中総一郎	固有一般
むらまつこうた	村松航太	固有一般
むらまつじゅん	村松潤	固有一般
むらまつたいすけ	村松大輔	固有一般
たいすけ	大輔	固有人名
むらまつともき	村松知輝	固有一般
ともき	知輝	固有人名
むらまつゆきのり	村松幸典	固有一般
ゆきのり	幸典	固有人名
むらもとそうた	村本相太	固有一般
むらやまかんじ	村山勘治	固有一般
かんじ	勘治	固有人名
むらやまたくま	村山拓真	固有一般
むらやまともひこ	村山智彦	固有一般
むらやまゆうすけ	村山祐介	固有一般
むろたくや	室拓哉	固有一般
むろいいちえい	室井市衛	固有一般
いちえい	市衛	固有人名
むろいけいすけ	室井彗佑	固有一般
けいすけ	彗佑	固有人名
むろつはやと	室津颯斗	固有一般
むろやせい	室屋成	固有一般
せい	成	固有人名
もんいんじゅ	文仁柱	固有一般
いんじゅ	仁柱	固有人名
もんじょちゅん	文濟天	固有一般
じょちゅん	濟天	固有人名
もんじゅうぐん	文周元	固有一般
じゅうぐん	周元	固有人名
めいそんのあ	メイソン埜吾	固有一般
のあ	埜吾	固有人名
めしのそうま	食野壮磨	固有一般
そうま	壮磨	固有人名
めしのりょうたろう	食野亮太郎	固有一般
りょうたろう	亮太郎	固有人名
めたけんいちろう	米田兼一郎	固有一般
けんいちろう	兼一郎	固有人名
めつぎけいご	目次啓悟	固有一般
けいご	啓悟	固有人名
めつぎこうせい	目次康晟	固有一般
こうせい	康晟	固有人名
もうりしゅんや	毛利駿也	固有一般
もぎかつゆき	茂木克行	固有一般
もぎしゅう	茂木秀	固有一般
しゅう	秀	固有人名
もぎひろと	茂木弘人	固有一般
もちいきょうた	持井響太	固有一般
きょうた	響太	固有人名
もちづきこうへい	望月耕平	固有一般
もちづきさとる	望月聡	固有一般
さとる	聡	固有人名
もちづきしげよし	望月重良	固有一般
しげよし	重良	固有人名
もちづきたつや	望月達也	固有一般
もちづきちかゆき	望月慎之	固有一般
ちかゆき	慎之	固有人名
もちづきまさと	望月理人	固有一般
もちづきゆうしん	望月勇伸	固有一般
ゆうしん	勇伸	固有人名
もちづきりゅうじ	望月竜次	固有一般
りゅうじ	竜次	固有人名
もちづきれお	望月嶺臣	固有一般
れお	嶺臣	固有人名
もちどめしんさく	持留新作	固有一般
しんさく	新作	固有人名
もてきしゅうや	茂木柊哉	固有一般
しゅうや	柊哉	固有人名
もてぎしゅんすけ	茂木駿佑	固有一般
もてぎりきや	茂木力也	固有一般
もといしなつ	本石捺	固有一般
なつ	捺	固有人名
もときれおん	元木玲音	固有一般
れおん	玲音	固有人名
もとだあらた	許田新太	固有一般
あらた	新太	固有人名
もとだりゅうや	元田龍矢	固有一般
りゅうや	龍矢	固有人名
もとづかとしや	本塚聖也	固有一般
としや	聖也	固有人名
もとはしたくみ	本橋卓巳	固有一般
たくみ	卓巳	固有人名
もとみやしゅうと	本宮周東	固有一般
しゅうと	周東	固有人名
もとやましょうげん	本山鐘現	固有一般
しょうげん	鐘現	固有人名
もとやまはるか	本山遥	固有一般
はるか	遥	固有人名
もとやままさし	本山雅志	固有一般
まさし	雅志	固有人名
もとよしたけし	本吉剛	固有一般
もにわてるゆき	茂庭照幸	固有一般
てるゆき	照幸	固有人名
もはまどふぁるざんさな	モハマドファルザン佐名	固有一般
ふぁるざんさな	ファルザン佐名	固有人名
もみたにまさひろ	籾谷真弘	固有一般
もよまるこむきょうし	モヨマルコム強志	固有一般
もりあつひこ	森敦彦	固有一般
あつひこ	敦彦	固有人名
もりえいじろう	森英次郎	固有一般
えいじろう	英次郎	固有人名
もりかいと	森海渡	固有一般
もりかずひろ	森一紘	固有一般
かずひろ	一紘	固有人名
もりけいすけ	森惠佑	固有一般
けいすけ	惠佑	固有人名
もりけんいち	森賢一	固有一般
もりこうた	森晃太	固有一般
もりこうたつ	森厚達	固有一般
こうたつ	厚達	固有人名
もりこうだい	森昂大	固有一般
もりしゅんすけ	森俊介	固有一般
もりじゅんいち	森純一	固有一般
もりたいじろう	森泰次郎	固有一般
もりとしき	森俊貴	固有一般
もりなおき	森直樹	固有一般
もりはるや	森春也	固有一般
はるや	春也	固有人名
もりひであき	森秀昭	固有一般
ひであき	秀昭	固有人名
もりまさあき	森正明	固有一般
もりゆうすけ	森勇介	固有一般
もりゆうと	森勇人	固有一般
もりゆり	森侑里	固有一般
ゆり	侑里	固有人名
もりゆうま	森夢真	固有一般
ゆうま	夢真	固有人名
もりよういち	森陽一	固有一般
もりようすけ	森洋介	固有一般
もりようへい	森陽平	固有一般
もりりいた	森璃太	固有一般
りいた	璃太	固有人名
もりおかしげる	森岡茂	固有一般
しげる	茂	固有人名
もりおかりく	森岡陸	固有一般
もりおかりゅうぞう	森岡隆三	固有一般
りゅうぞう	隆三	固有人名
もりおかりょうた	森岡亮太	固有一般
もりかわたいしん	森川泰臣	固有一般
たいしん	泰臣	固有人名
もりかわたくみ	森川拓巳	固有一般
もりかわとおる	森川徹	固有一般
もりかわゆうき	森川裕基	固有一般
ゆうき	裕基	固有人名
もりかわりゅうせい	森川龍誠	固有一般
りゅうせい	龍誠	固有人名
もりさきかずゆき	森﨑和幸	固有一般
もりさきこうじ	森﨑浩司	固有一般
もりさきよしゆき	森崎嘉之	固有一般
よしゆき	嘉之	固有人名
もりしげたつや	森重達也	固有一般
もりしげまさと	森重真人	固有一般
もり	森重陽介	固有一般
もりしたこたろう	森下虎太郎	固有一般
もりしたしゅん	森下俊	固有一般
もりしたしんいち	森下申一	固有一般
しんいち	申一	固有人名
もりしたはるか	森下悠	固有一般
はるか	悠	固有人名
もりしたひとし	森下仁志	固有一般
もりしたりょうや	森下龍矢	固有一般
りょうや	龍矢	固有人名
もりしたれいや	森下怜哉	固有一般
れいや	怜哉	固有人名
もりしまつかさ	森島司	固有一般
もりしまひろあき	森島寛晃	固有一般
ひろあき	寛晃	固有人名
もりしまやすひと	森島康仁	固有一般
もりぞのたかひと	森園貴仁	固有一般
もりたこういちろう	森田耕一郎	固有一般
もりたこうき	森田晃樹	固有一般
もりたこうへい	盛田剛平	固有一般
こうへい	剛平	固有人名
もりたしょう	森田翔	固有一般
もりたしんご	森田慎吾	固有一般
もりたしんご	森田真吾	固有一般
もりたしんじ	森田真司	固有一般
もりたそう	守田創	固有一般
もりたたつや	守田達弥	固有一般
もりたつばさ	森田翼	固有一般
もりたなる	森田成	固有一般
もりたはやた	森田颯太	固有一般
もりたひでまさ	守田英正	固有一般
ひでまさ	英正	固有人名
もりたひろし	森田浩史	固有一般
もりたゆうき	森田侑樹	固有一般
ゆうき	侑樹	固有人名
もりたゆうと	森田友翔	固有一般
もりたりん	森田凜	固有一般
りん	凜	固有人名
もりたれん	森田蓮	固有一般
もりむらこうた	森村昂太	固有一般
こうた	昂太	固有人名
もりもといぶき	森本聖希	固有一般
いぶき	聖希	固有人名
もりもとしんいち	森本慎一	固有一般
もりもとそらと	森本空斗	固有一般
そらと	空斗	固有人名
もりもとたかゆき	森本貴幸	固有一般
もりもとだいき	森本大貴	固有一般
もりもとつかさ	森本良	固有一般
つかさ	良	固有人名
もりもとひまん	森本ヒマン	固有一般
ひまん	ヒマン	固有人名
もりやかずと	森谷一斗	固有一般
もりやけいすけ	森谷佳祐	固有一般
もりやけんたろう	森谷賢太郎	固有一般
もりやはやと	守屋颯人	固有一般
もりやすしょうへい	森保翔平	固有一般
もりやすはじめ	森保一	固有一般
はじめ	一	固有人名
もりやすひろし	森保洋	固有一般
もりやすひろふみ	森安洋文	固有一般
ひろふみ	洋文	固有人名
もりやすりく	森保陸	固有一般
もりやまきみや	森山公弥	固有一般
きみや	公弥	固有人名
もりやまけんじ	守山健二	固有一般
もりやましんご	森山真伍	固有一般
もりやまともひろ	森山友裕	固有一般
ともひろ	友裕	固有人名
もりやまやすゆき	森山泰行	固有一般
やすゆき	泰行	固有人名
もりやまよしろう	森山佳郎	固有一般
よしろう	佳郎	固有人名
もりよしゆうたろう	森吉優太郎	固有一般
ゆうたろう	優太郎	固有人名
もりわきりょうた	森脇良太	固有一般
もれいられおなるど	盛礼良 レオナルド	固有一般
もろおかしゅう	師岡柊生	固有一般
しゅう	柊生	固有人名
もろおかひろと	諸岡裕人	固有一般
やがらけんいち	八柄堅一	固有一般
けんいち	堅一	固有人名
やぎかいせい	矢木海成	固有一般
かいせい	海成	固有人名
やぎたいせい	八木大政	固有一般
たいせい	大政	固有人名
やぎひろと	八木大翔	固有一般
やぎしただいき	柳下大樹	固有一般
やぎぬましゅん	八木沼瞬	固有一般
やくしじだいき	薬師寺大繋	固有一般
だいき	大繋	固有人名
やぐちしゅんたろう	矢口駿太郎	固有一般
やざわたつや	谷澤達也	固有一般
やしきゆうせい	屋敷優成	固有一般
やしろさとし	八代敏	固有一般
さとし	敏	固有人名
やじまきいち	矢島輝一	固有一般
きいち	輝一	固有人名
やじましんや	矢島慎也	固有一般
やじまたくろう	矢島卓郎	固有一般
たくろう	卓郎	固有人名
やすいかいと	安居海渡	固有一般
やすいたくや	安井拓也	固有一般
やすかわゆう	安川有	固有一般
ゆう	有	固有人名
やすたけとおる	安武亨	固有一般
やすだけんしん	保田堅心	固有一般
けんしん	堅心	固有人名
やすだこうすけ	安田亘佑	固有一般
こうすけ	亘佑	固有人名
やすだこうだい	安田晃大	固有一般
こうだい	晃大	固有人名
やすだこうじろう	安田虎士朗	固有一般
こうじろう	虎士朗	固有人名
やすだなる	保田成琉	固有一般
なる	成琉	固有人名
やすだみちひろ	安田理大	固有一般
みちひろ	理大	固有人名
やすだゆうき	安田祐生	固有一般
ゆうき	祐生	固有人名
やすながそうたろう	安永聡太郎	固有一般
そうたろう	聡太郎	固有人名
やすながみど	安永海童	固有一般
みど	海童	固有人名
やすながれお	安永玲央	固有一般
やすはらなりやす	安原成泰	固有一般
なりやす	成泰	固有人名
やすみつしょうさく	安光将作	固有一般
しょうさく	将作	固有人名
やそゆうじ	八十祐治	固有一般
やたがいそうき	矢田貝壮貴	固有一般
そうき	壮貴	固有人名
やたあさひ	矢田旭	固有一般
やだゆうすけ	谷田悠介	固有一般
やだりゅうのすけ	矢田龍之介	固有一般
やちだてっぺい	谷内田哲平	固有一般
やつだこうすけ	八田康介	固有一般
やないあつし	柳井敦志	固有一般
やながわまさき	柳川雅樹	固有一般
やなぎおうじろう	柳欧治郎	固有一般
おうじろう	欧治郎	固有人名
やなぎたかひろ	柳貴博	固有一般
やなぎやすたか	柳育崇	固有一般
やすたか	育崇	固有人名
やなぎゆうたろう	柳雄太郎	固有一般
やなぎりくと	柳陸斗	固有一般
やなぎさわあつし	柳沢敦	固有一般
やなぎさわこう	柳澤亘	固有一般
こう	亘	固有人名
やなぎさわこうた	柳澤宏太	固有一般
やなぎさわじゅん	柳澤隼	固有一般
やなぎさわまさゆき	柳沢将之	固有一般
まさゆき	将之	固有人名
やなぎざきしょうへい	柳崎祥兵	固有一般
やなぎそのりょうた	柳園良太	固有一般
やなぎだけんた	柳田健太	固有一般
やなぎだたくみ	桺田拓海	固有一般
やなぎまちかいよう	柳町魁耀	固有一般
かいよう	魁耀	固有人名
やなぎもとひろしげ	柳本啓成	固有一般
ひろしげ	啓成	固有人名
やなしばまさや	柳下将野	固有一般
まさや	将野	固有人名
やなむらはるき	柳村治輝	固有一般
やのきしょう	矢野貴章	固有一般
きしょう	貴章	固有人名
やのたいち	矢野太一	固有一般
やのだいすけ	矢野大輔	固有一般
やのはやと	矢野隼人	固有一般
やのまいける	矢野マイケル	固有一般
まいける	マイケル	固有人名
やのゆうすい	矢野佑粋	固有一般
ゆうすい	佑粋	固有人名
やはたとしひろ	矢畑智裕	固有一般
としひろ	智裕	固有人名
やぶゆうじ	養父雄仁	固有一般
ゆうじ	雄仁	固有人名
やぶうちけんと	薮内健人	固有一般
やぶさきしんや	薮崎真哉	固有一般
しんや	真哉	固有人名
やぶたみつのり	藪田光教	固有一般
みつのり	光教	固有人名
やべじろう	矢部次郎	固有一般
やまうちあきら	山内彰	固有一般
やまうちかける	山内翔	固有一般
やまうちかんてる	山内勘暉	固有一般
かんてる	勘暉	固有人名
やまうちけいた	山内恵太	固有一般
やまうちこうだい	山内康太	固有一般
こうだい	康太	固有人名
やまうちしゅうせい	山内舟征	固有一般
しゅうせい	舟征	固有人名
やまうちたかお	山内貴雄	固有一般
たかお	貴雄	固有人名
やまうちたつろう	山内達朗	固有一般
やまうちともひろ	山内智裕	固有一般
ともひろ	智裕	固有人名
やまうちはるき	山内晴貴	固有一般
やまうちひなた	山内日向汰	固有一般
ひなた	日向汰	固有人名
やまうちひろふみ	山内寛史	固有一般
ひろふみ	寛史	固有人名
やまうちゆういち	山内祐一	固有一般
ゆういち	祐一	固有人名
やまうちゆうま	山内悠真	固有一般
ゆうま	悠真	固有人名
やまうちりく	山内陸	固有一般
やまおみつのり	山尾光則	固有一般
みつのり	光則	固有人名
やまおかくんぺい	山岡薫平	固有一般
やまおかてつや	山岡哲也	固有一般
やまかわてつし	山川哲史	固有一般
てつし	哲史	固有人名
やまかわでしょんりょう	山川デション諒	固有一般
でしょんりょう	デション諒	固有人名
やまかわれん	山川廉	固有一般
やまがかずき	山賀和輝	固有一般
やまがたきょうへい	山形恭平	固有一般
やまがたたつのり	山形辰徳	固有一般
やまがわだいち	山側大地	固有一般
やまぎしさとる	山岸智	固有一般
さとる	智	固有人名
やまぎしのりひろ	山岸範宏	固有一般
のりひろ	範宏	固有人名
やまぎしゆうや	山岸祐也	固有一般
やまくらわたる	山倉渉	固有一般
やまぐちあつし	山口篤史	固有一般
あつし	篤史	固有人名
やまぐちかずき	山口和樹	固有一般
やまぐちかずま	山口一真	固有一般
やまぐちけい	山口慶	固有一般
やまぐちさとし	山口智	固有一般
やまぐちしょうだい	山口将大	固有一般
しょうだい	将大	固有人名
やまぐちしんじ	山口真司	固有一般
やまぐちせいや	山口聖矢	固有一般
せいや	聖矢	固有人名
やまぐちたかひろ	山口貴弘	固有一般
やまぐちたかゆき	山口貴之	固有一般
やまぐちたくみ	山口卓己	固有一般
やまぐちたけし	山口武士	固有一般
やまぐちたつや	山口竜弥	固有一般
たつや	竜弥	固有人名
やまぐちだいき	山口大輝	固有一般
やまぐちてつはる	山口哲治	固有一般
てつはる	哲治	固有人名
やまぐちとしひろ	山口敏弘	固有一般
やまぐちほたる	山口 蛍	固有一般
やまぐちもとひろ	山口素弘	固有一般
もとひろ	素弘	固有人名
やまぐちゆうき	山口優樹	固有一般
やまぐちゆうき	山口勇気	固有一般
やまぐちりゅうき	山口隆希	固有一般
りゅうき	隆希	固有人名
やまぐちるい	山口瑠伊	固有一般
るい	瑠伊	固有人名
やまこしきょうたろう	山越享太郎	固有一般
きょうたろう	享太郎	固有人名
やまこしこうへい	山越康平	固有一般
やまさきおが	山﨑桜我	固有一般
おが	桜我	固有人名
やまざききいち	山崎希一	固有一般
きいち	希一	固有人名
やまざきしゅうき	山崎宗樹	固有一般
しゅうき	宗樹	固有人名
やまざきしゅうと	山崎柊人	固有一般
やまさきたいち	山﨑大地	固有一般
たいち	大地	固有人名
やまざきまさと	山崎理人	固有一般
やまさきりく	山﨑琉空	固有一般
りく	琉空	固有人名
やまさきりむ	山﨑琉夢	固有一般
りむ	琉夢	固有人名
やまざきりょうご	山﨑 凌吾	固有一般
やまさきるか	山﨑琉煌	固有一般
るか	琉煌	固有人名
やまざきかける	山崎翔流	固有一般
かける	翔流	固有人名
やまざきこうすけ	山﨑浩介	固有一般
やまざきこうせい	山﨑公誠	固有一般
こうせい	公誠	固有人名
やまざきこうたろう	山崎光太郎	固有一般
やまざきたいしん	山崎太新	固有一般
たいしん	太新	固有人名
やまざきたかまさ	山﨑貴雅	固有一般
たかまさ	貴雅	固有人名
やまざきてつや	山崎哲也	固有一般
やまざきまこと	山崎真	固有一般
やまざきまさと	山﨑 雅人	固有一般
やまざきまさと	山﨑正登	固有一般
まさと	正登	固有人名
やまざきゆうき	山崎侑輝	固有一般
やまざきりょうすけ	山崎稜介	固有一般
やまざきりょうへい	山崎亮平	固有一般
やまざきりん	山崎倫	固有一般
やまざきわたる	山崎渡	固有一般
わたる	渡	固有人名
やましたくにひろ	山下訓広	固有一般
くにひろ	訓広	固有人名
やましたけいた	山下敬大	固有一般
やましたしょうま	山下将真	固有一般
しょうま	将真	固有人名
やましたそうたろう	山下湊太郎	固有一般
そうたろう	湊太郎	固有人名
やましたたつや	山下達也	固有一般
やましたゆだい	山下雄大	固有一般
ゆだい	雄大	固有人名
やましたゆうと	山下優人	固有一般
やましたよしみ	山下芳輝	固有一般
よしみ	芳輝	固有人名
やましたらいど	山下莉人	固有一般
らいど	莉人	固有人名
やましたりょう	山下諒	固有一般
やましたりょうじ	山下諒時	固有一般
りょうじ	諒時	固有人名
やましたりょうや	山下諒也	固有一般
やましたれお	山下令雄	固有一般
れお	令雄	固有人名
やましたれん	山下廉	固有一般
やましろじゅんや	山城純也	固有一般
やまじいっさ	山地一颯	固有一般
いっさ	一颯	固有人名
やまじよしひと	山路嘉人	固有一般
やませこうじ	山瀬功治	固有一般
こうじ	功治	固有人名
やませゆきひろ	山瀬幸宏	固有一般
ゆきひろ	幸宏	固有人名
やまだいつき	山田樹	固有一般
やまだかいと	山田海斗	固有一般
やまだきお	山田葵士	固有一般
きお	葵士	固有人名
やまだきょうや	山田恭也	固有一般
きょうや	恭也	固有人名
やまだきらと	山田煌人	固有一般
きらと	煌人	固有人名
やまだけんじ	山田賢二	固有一般
やまだげんき	山田元気	固有一般
やまだこうしん	山田光真	固有一般
こうしん	光真	固有人名
やまだこうじ	山田晃士	固有一般
こうじ	晃士	固有人名
やまだこうた	山田康太	固有一般
やまだこうへい	山田晃平	固有一般
やまだごうき	山田剛綺	固有一般
ごうき	剛綺	固有人名
やまだしゅうへい	山田周平	固有一般
やまだしゅうへい	山田修平	固有一般
やまだしう	山田士雄	固有一般
しう	士雄	固有人名
やまだしん	山田新	固有一般
しん	新	固有人名
やまだたいき	山田泰樹	固有一般
たいき	泰樹	固有人名
やまだたいき	山田大樹	固有一般
やまだたかひろ	山田隆裕	固有一般
たかひろ	隆裕	固有人名
やまだたかふみ	山田貴文	固有一般
やまだたくみ	山田拓巳	固有一般
やまだたくや	山田卓也	固有一般
やまだつばさ	山田翼	固有一般
やまだなお	山田奈央	固有一般
なお	奈央	固有人名
やまだなおき	山田直輝	固有一般
やまだなおゆき	山田尚幸	固有一般
なおゆき	尚幸	固有人名
やまだのぶひさ	山田暢久	固有一般
のぶひさ	暢久	固有人名
やまだひろき	山田大記	固有一般
ひろき	大記	固有人名
やまだひろと	山田太翔	固有一般
ひろと	太翔	固有人名
やまだひろと	山田寛人	固有一般
やまだふうき	山田楓喜	固有一般
ふうき	楓喜	固有人名
やまだまさみち	山田正道	固有一般
まさみち	正道	固有人名
やまだまさゆき	山田将之	固有一般
やまだまなと	山田真夏斗	固有一般
まなと	真夏斗	固有人名
やまだみつお	山田満夫	固有一般
みつお	満夫	固有人名
やまだやすひろ	山田泰寛	固有一般
やすひろ	泰寛	固有人名
やまだゆうき	山田祐樹	固有一般
やまだゆうじ	山田雄士	固有一般
ゆうじ	雄士	固有人名
やまだゆうや	山田裕也	固有一般
やまだよしふみ	山田祥史	固有一般
よしふみ	祥史	固有人名
やまだりく	山田陸	固有一般
やまだりく	山田理矩	固有一般
りく	理矩	固有人名
やまだりょうせい	山田凌聖	固有一般
りょうせい	凌聖	固有人名
やまとかいり	大和海里	固有一般
やまとてつ	大和哲	固有一般
やまとはるき	大和陽希	固有一般
はるき	陽希	固有人名
やまとゆづき	大和優槻	固有一般
ゆづき	優槻	固有人名
やまとれん	大和蓮	固有一般
やまなかあつき	山中惇希	固有一般
やまなかけんた	山中健太	固有一般
やまなかしゅうせい	山中柊生	固有一般
しゅうせい	柊生	固有人名
やまなかせいこう	山中誠晃	固有一般
せいこう	誠晃	固有人名
やまなかりょうじ	山中良二	固有一般
やまなかりょうすけ	山中亮輔	固有一般
やまなかれお	山中麗央	固有一般
やまにしたかひろ	山西尊裕	固有一般
たかひろ	尊裕	固有人名
やまねいわお	山根巌	固有一般
いわお	巌	固有人名
やまねけんせい	山根顕星	固有一般
けんせい	顕星	固有人名
やまねとわ	山根永遠	固有一般
やまねなお	山根成陽	固有一般
なお	成陽	固有人名
やまねみき	山根視来	固有一般
みき	視来	固有人名
やまねりく	山根陸	固有一般
やまのはる	山野悠	固有一般
はる	悠	固有人名
やまのいたくみ	山ノ井拓己	固有一般
やまのうちゆうき	山之内優貴	固有一般
やまはしたかし	山橋貴史	固有一般
やまはらこうたろう	山原康太郎	固有一般
やまはられおん	山原怜音	固有一般
やまふじけんた	山藤健太	固有一般
やまべたつき	山邊樹	固有一般
やまみひろと	山見大登	固有一般
やまみちこうへい	山道高平	固有一般
こうへい	高平	固有人名
やまみちじゅんじ	山道淳司	固有一般
じゅんじ	淳司	固有人名
やまむらかずや	山村和也	固有一般
やまむらひろと	山村博土	固有一般
ひろと	博土	固有人名
やまむらやすひろ	山村泰弘	固有一般
やすひろ	泰弘	固有人名
やまむらゆうき	山村佑樹	固有一般
やまもとあやと	山本彩斗	固有一般
あやと	彩斗	固有人名
やまもといさむ	山本勇武	固有一般
やまもといちや	山本一哉	固有一般
いちや	一哉	固有人名
やまもとおおた	山本桜大	固有一般
おおた	桜大	固有人名
やまもとかいと	山本海人	固有一般
やまもとかえで	山本楓	固有一般
やまもとけんじ	山本健二	固有一般
やまもとけんじ	山本健司	固有一般
やまもとこうすけ	山本康裕	固有一般
こうすけ	康裕	固有人名
やまもとこうへい	山本孝平	固有一般
やまもとしゅうと	山本脩斗	固有一般
やまもとしゅんすけ	山本隼輔	固有一般
やまもとしゅんすけ	山本駿亮	固有一般
しゅんすけ	駿亮	固有人名
やまもとしょうたろう	山本将太郎	固有一般
しょうたろう	将太郎	固有人名
やまもとしょうへい	山本翔平	固有一般
やまもとじょうい	山本丈偉	固有一般
やまもとそうたろう	山本宗太朗	固有一般
そうたろう	宗太朗	固有人名
やまもとたくや	山本拓弥	固有一般
やまもとたいき	山本大稀	固有一般
たいき	大稀	固有人名
やまもととうい	山本透衣	固有一般
とうい	透衣	固有人名
やまもとのりみち	山本義道	固有一般
のりみち	義道	固有人名
やまもとひでおみ	山本英臣	固有一般
ひでおみ	英臣	固有人名
やまもとひなた	山本陽大	固有一般
ひなた	陽大	固有人名
やまもとひろき	山本大貴	固有一般
やまもとひろき	山本祥輝	固有一般
ひろき	祥輝	固有人名
やまもとひろと	山本啓人	固有一般
やまもとひろまさ	山本浩正	固有一般
ひろまさ	浩正	固有人名
やまもとふじお	山本富士雄	固有一般
ふじお	富士雄	固有人名
やまもとまさき	山本真希	固有一般
まさき	真希	固有人名
やまもとまさや	山本真也	固有一般
まさや	真也	固有人名
やまもとゆうき	山本悠樹	固有一般
ゆうき	悠樹	固有人名
やまもとよしき	山本祥輝	固有一般
よしき	祥輝	固有人名
やまもとりひと	山本理仁	固有一般
やまもとりゅうへい	山本龍平	固有一般
りゅうへい	龍平	固有人名
やまもとりょうたろう	山本凌太郎	固有一般
やまもとりん	山本凜	固有一般
やまもとれん	山本蓮	固有一般
やまもとれん	山本廉	固有一般
やまやゆうし	山谷侑士	固有一般
ゆうし	侑士	固有人名
やまわきかおる	山脇樺織	固有一般
かおる	樺織	固有人名
やむらけん	矢村健	固有一般
やりみずそま	鑓水壮真	固有一般
そま	壮真	固有人名
やりみずりょうせい	鑓水澪星	固有一般
りょうせい	澪星	固有人名
やんふぁん	楊帆	固有一般
ふぁん	帆	固有人名
ゆさんちゅる	柳想鐵	固有一般
さんちゅる	想鐵	固有人名
ゆじは	柳知廈	固有一般
じは	知廈	固有人名
ゆひょうじん	劉孝眞	固有一般
ひょうじん	孝眞	固有人名
ゆあされお	湯浅礼生	固有一般
れお	礼生	固有人名
ゆいこうた	由井航太	固有一般
ゆうきこうぞう	結城耕造	固有一般
こうぞう	耕造	固有人名
てらだゆうさく	寺田優作	固有一般
ゆままさや	遊馬将也	固有一般
ゆきえひろと	雪江悠人	固有一般
ひろと	悠人	固有人名
ゆくともとき	行友翔哉	固有一般
とき	翔哉	固有人名
ゆげつばさ	弓削翼	固有一般
ゆさかつみ	遊佐克美	固有一般
かつみ	克美	固有人名
ゆざわたくし	湯澤拓士	固有一般
たくし	拓士	固有人名
ゆざわまさと	湯澤聖人	固有一般
ゆざわようすけ	湯澤洋介	固有一般
ゆだかい	湯田海	固有一般
ゆはらたけあき	油原丈著	固有一般
たけあき	丈著	固有人名
ゆみさききょうへい	弓崎恭平	固有一般
ゆみばまさき	弓場将輝	固有一般
ゆもとそうや	湯本創也	固有一般
そうや	創也	固有人名
ゆるきこうや	汰木康也	固有一般
ゆんじょんふぁん	尹晶煥	固有一般
じょんふぁん	晶煥	固有人名
ゆんちゃんす	尹昌洙	固有一般
ちゃんす	昌洙	固有人名
ゆさんぶん	余善文	固有一般
さんぶん	善文	固有人名
よすんはえ	呂 成海	固有一般
よひょうじん	余孝珍	固有一般
ひょうじん	孝珍	固有人名
よかみきお	養日幹大	固有一般
みきお	幹大	固有人名
よだゆういち	要田勇一	固有一般
ゆういち	勇一	固有人名
よつまさき	養津正樹	固有一般
よこうちあきのぶ	横内昭展	固有一般
あきのぶ	昭展	固有人名
よこかわあさひ	横川旦陽	固有一般
あさひ	旦陽	固有人名
よこかわいずみ	横川泉	固有一般
いずみ	泉	固有人名
よこぜきこういち	横関浩一	固有一般
よこたしょうや	横田翔也	固有一般
よこただいすけ	横田大祐	固有一般
よこたけつばさ	横竹翔	固有一般
つばさ	翔	固有人名
よこたにしげる	横谷繁	固有一般
よこのじゅんき	横野純貴	固有一般
じゅんき	純貴	固有人名
よこみぞこうた	横溝広太	固有一般
よこやまあきゆき	横山暁之	固有一般
あきゆき	暁之	固有人名
よこやまあゆむ	横山歩夢	固有一般
よこやまさとし	横山聡	固有一般
よこやましゅんすけ	横山俊介	固有一般
よこやましょうだい	横山翔大	固有一般
しょうだい	翔大	固有人名
よこやましょうへい	横山翔平	固有一般
よこやまじょい	横山序生	固有一般
じょい	序生	固有人名
よこやまそうた	横山聡太	固有一般
よこやまたかゆき	横山貴之	固有一般
よこやまたくじ	横山卓司	固有一般
たくじ	卓司	固有人名
よこやまたくや	横山拓也	固有一般
よこやまとものぶ	横山知伸	固有一般
よこやまともや	横山智也	固有一般
よこやまなおき	横山尚貴	固有一般
なおき	尚貴	固有人名
よこやまひろとし	横山博敏	固有一般
ひろとし	博敏	固有人名
よこやまゆうじ	横山雄次	固有一般
よこやまゆめき	横山夢樹	固有一般
ゆめき	夢樹	固有人名
よこやまるい	横山塁	固有一般
よしいこうすけ	吉井孝輔	固有一般
こうすけ	孝輔	固有人名
よしいたいき	吉井泰生	固有一般
たいき	泰生	固有人名
よしいたくま	吉井拓真	固有一般
よしいなおと	吉井直人	固有一般
よしいゆうすけ	吉井佑将	固有一般
ゆうすけ	佑将	固有人名
よしおかいな	吉尾海夏	固有一般
かいな	海夏	固有人名
よしおかけいた	喜岡佳太	固有一般
けいた	佳太	固有人名
よしおかこうへい	吉岡航平	固有一般
よしおかさとし	吉岡聡	固有一般
よしおかひでき	吉岡秀樹	固有一般
よしおかまさかず	吉岡雅和	固有一般
まさかず	雅和	固有人名
よしかわきょうすけ	吉川京輔	固有一般
きょうすけ	京輔	固有人名
よしかわけんた	吉川健太	固有一般
よしかわこた	吉川虎王達	固有一般
こた	虎王達	固有人名
よしかわしょうご	吉川翔梧	固有一般
しょうご	翔梧	固有人名
よしかわたくや	吉川拓也	固有一般
よしかわなおき	吉川直輝	固有一般
よしざきかつや	吉嵜勝哉	固有一般
かつや	勝哉	固有人名
よしざきひろのぶ	吉崎弘宣	固有一般
ひろのぶ	弘宣	固有人名
よしざきゆうすけ	吉崎雄亮	固有一般
ゆうすけ	雄亮	固有人名
よしざわしゅう	吉澤柊	固有一般
よしざわしょうたろう	義澤将太郎	固有一般
よしざわみらい	吉沢実頼	固有一般
みらい	実頼	固有人名
よしざわゆうき	義澤侑樹	固有一般
よしざわゆうや	吉澤佑哉	固有一般
よしたけつよし	吉武剛	固有一般
よしたけりお	吉武莉央	固有一般
りお	莉央	固有人名
よしたにきずな	芳谷絆	固有一般
きずな	絆	固有人名
よしだあきお	吉田明生	固有一般
あきお	明生	固有人名
よしだあきひろ	吉田明博	固有一般
あきひろ	明博	固有人名
よしだあきよし	吉田顕清	固有一般
あきよし	顕清	固有人名
よしだあきら	吉田晃	固有一般
よしだあらた	吉田新	固有一般
よしだいぶき	吉田伊吹	固有一般
よしだかずき	吉田和暉	固有一般
かずき	和暉	固有人名
よしだけんたろう	吉田賢太郎	固有一般
よしだげんたろう	吉田源太郎	固有一般
よしだこうき	吉田光希	固有一般
よしださちお	吉田幸生	固有一般
さちお	幸生	固有人名
よしださとし	吉田智志	固有一般
さとし	智志	固有人名
よしださとる	吉田悟	固有一般
よしだしゅん	吉田舜	固有一般
よしだしゅん	吉田峻	固有一般
よしだじんぺい	吉田陣平	固有一般
じんぺい	陣平	固有人名
よしだたいじゅ	吉田泰授	固有一般
たいじゅ	泰授	固有人名
よしだたかゆき	吉田孝行	固有一般
たかゆき	孝行	固有人名
よしだたつま	吉田達磨	固有一般
よしだとおる	吉田暢	固有一般
とおる	暢	固有人名
よしだともき	吉田知樹	固有一般
よしだともひさ	吉田智尚	固有一般
ともひさ	智尚	固有人名
よしだともやす	吉田朋恭	固有一般
ともやす	朋恭	固有人名
よしだないと	吉田騎	固有一般
ないと	騎	固有人名
よしだなおや	吉田直矢	固有一般
なおや	直矢	固有人名
よしだはやて	吉田颯	固有一般
よしだはるき	吉田晴稀	固有一般
はるき	晴稀	固有人名
よしだはるき	吉田温紀	固有一般
はるき	温紀	固有人名
よしだひかる	吉田光	固有一般
よしだひろまさ	芳田大将	固有一般
よしだひろゆき	吉田裕幸	固有一般
ひろゆき	裕幸	固有人名
よしだまきと	吉田眞紀人	固有一般
まきと	眞紀人	固有人名
よしだまさき	吉田正樹	固有一般
よしだまさふみ	吉田真史	固有一般
まさふみ	真史	固有人名
よしだまさや	吉田将也	固有一般
よしだまさよし	吉田匡良	固有一般
まさよし	匡良	固有人名
よしだまなと	吉田真那斗	固有一般
まなと	真那斗	固有人名
よしだまや	吉田麻也	固有一般
まや	麻也	固有人名
よしだみつのり	吉田光範	固有一般
みつのり	光範	固有人名
よしだみなと	吉田実成都	固有一般
みなと	実成都	固有人名
よしだめぐむ	吉田恵	固有一般
よしだむねひろ	吉田宗弘	固有一般
むねひろ	宗弘	固有人名
よしだやすたか	吉田安孝	固有一般
やすたか	安孝	固有人名
よしだやすひろ	吉田康弘	固有一般
よしだゆいと	吉田唯人	固有一般
よしだゆうじ	吉田有志	固有一般
ゆうじ	有志	固有人名
よしだゆうたろう	吉田雄汰朗	固有一般
ゆうたろう	雄汰朗	固有人名
よしだゆづき	吉田柚輝	固有一般
ゆづき	柚輝	固有人名
よしだゆたか	吉田豊	固有一般
よしだらいき	吉田来綺	固有一般
らいき	来綺	固有人名
よしとみしゅんすけ	吉富駿介	固有一般
よしなおだいと	吉直大翔	固有一般
だいと	大翔	固有人名
よしながしょい	吉永昇偉	固有一般
しょい	昇偉	固有人名
よしながたかまさ	吉永孝政	固有一般
たかまさ	孝政	固有人名
よしながひろし	吉永大志	固有一般
ひろし	大志	固有人名
よしながまひろ	吉長真優	固有一般
まひろ	真優	固有人名
よしなりこうじ	吉成浩司	固有一般
よしなりはると	吉成遥斗	固有一般
よしなれたかや	吉馴空矢	固有一般
たかや	空矢	固有人名
よしのきょうへい	吉野恭平	固有一般
よしのたかみつ	吉野峻光	固有一般
たかみつ	峻光	固有人名
よしのともゆき	吉野智行	固有一般
よしのはると	吉野陽翔	固有一般
よしのゆうたろう	吉野裕太郎	固有一般
よしのよしき	吉野喜貴	固有一般
よしき	喜貴	固有人名
よしはまりょうへい	吉濱遼平	固有一般
りょうへい	遼平	固有人名
よしはらこうた	吉原宏太	固有一般
よしはらしゅうすけ	吉原秀祐	固有一般
しゅうすけ	秀祐	固有人名
よしはらしんや	吉原慎也	固有一般
よしはらたいと	吉原大登	固有一般
たいと	大登	固有人名
よしはらまさと	吉原正人	固有一般
よしはらゆうき	吉原優輝	固有一般
よしひらつばさ	吉平翼	固有一般
よしひろみつゆき	吉弘充志	固有一般
みつゆき	充志	固有人名
よしまるけんしん	吉丸絢梓	固有一般
けんしん	絢梓	固有人名
よしみいっせい	吉見一星	固有一般
いっせい	一星	固有人名
よしみなつき	吉見夏樹	固有一般
なつき	夏樹	固有人名
よしみずいつき	吉水樹	固有一般
よしみつだいすけ	吉満大介	固有一般
よしむらぎんが	吉村銀河	固有一般
ぎんが	銀河	固有人名
よしむらけいじ	吉村圭司	固有一般
よしむらこういち	吉村耕一	固有一般
よしむらこうじ	吉村光示	固有一般
こうじ	光示	固有人名
よしむらとしひろ	吉村寿洋	固有一般
としひろ	寿洋	固有人名
よしむらゆずる	吉村弦	固有一般
ゆずる	弦	固有人名
よしむられお	吉村伶雄	固有一般
れお	伶雄	固有人名
よしもとあつし	吉本淳	固有一般
よしもとかずのり	吉本一謙	固有一般
かずのり	一謙	固有人名
よしもとくが	吉本空雅	固有一般
くが	空雅	固有人名
よしもとたかふみ	吉本岳史	固有一般
たかふみ	岳史	固有人名
よしもとゆうき	吉本勇気	固有一般
よだみつまさ	依田光正	固有一般
みつまさ	光正	固有人名
よどかわせいじゅ	淀川誠珠	固有一般
せいじゅ	誠珠	固有人名
よなしろともき	与那城智希	固有一般
ともき	智希	固有人名
よなはこうわ	与那覇航和	固有一般
こうわ	航和	固有人名
よねくらこき	米倉恒貴	固有一般
こき	恒貴	固有人名
よねくらまこと	米倉誠	固有一般
よねざわたけし	米澤剛志	固有一般
たけし	剛志	固有人名
よねざわてつや	米澤哲哉	固有一般
よねざわれい	米澤令衣	固有一般
れい	令衣	固有人名
よねだしゅんや	米田隼也	固有一般
しゅんや	隼也	固有人名
よねはらしゅうすけ	米原秀亮	固有一般
しゅうすけ	秀亮	固有人名
よねはらゆう	米原祐	固有一般
ゆう	祐	固有人名
よねもとたくじ	米本拓司	固有一般
たくじ	拓司	固有人名
よねやまあつし	米山篤志	固有一般
よねやまさとし	米山智	固有一般
よねやまだいすけ	米山大輔	固有一般
よねやまりゅういち	米山隆一	固有一般
りゅういち	隆一	固有人名
よめさかしょうた	嫁阪翔太	固有一般
よりいけん	寄井憲	固有一般
らくやまたかし	楽山孝志	固有一般
たかし	孝志	固有人名
らもするい	ラモス瑠偉	固有一般
りきょんじゅ	李京樹	固有一般
きょんじゅ	京樹	固有人名
りただなり	李忠成	固有一般
ただなり	忠成	固有人名
りちぇぐん	李在根	固有一般
ちぇぐん	在根	固有人名
りちゃんお	李将吾	固有一般
ちゃんお	将吾	固有人名
りちゃんがん	李彰剛	固有一般
ちゃんがん	彰剛	固有人名
りちゃんす	李将樹	固有一般
ちゃんす	将樹	固有人名
りかんせい	李漢宰	固有一般
かんせい	漢宰	固有人名
りよんじき	李栄直	固有一般
よんじき	栄直	固有人名
りきやすしょうご	力安祥伍	固有一般
しょうご	祥伍	固有人名
りょうひょんじゅ	梁賢柱	固有一般
ひょんじゅ	賢柱	固有人名
りょうよんぎ	梁勇基	固有一般
よんぎ	勇基	固有人名
りょうひろと	梁大翔	固有一般
りんどうまこと	林堂眞	固有一般
りゅしゅうあん	呂薛安	固有一般
しゅうあん	薛安	固有人名
ろくたんゆうじ	六反勇治	固有一般
ゆうじ	勇治	固有人名
わかいけんじ	若井研治	固有一般
けんじ	研治	固有人名
わかさまさし	若狭大志	固有一般
まさし	大志	固有人名
わかさゆうじ	輪笠祐士	固有一般
ゆうじ	祐士	固有人名
わかすぎこうき	若杉好輝	固有一般
こうき	好輝	固有人名
わかすぎたくや	若杉拓哉	固有一般
わかつきやまと	若月大和	固有一般
わかはらともや	若原智哉	固有一般
わかばやしまなふ	若林学歩	固有一般
まなふ	学歩	固有人名
わかばやしまなぶ	若林学	固有一般
わかばやしらいや	若林頼以弥	固有一般
らいや	頼以弥	固有人名
わかばやしりゅう	若林龍	固有一般
わかまつけんじ	若松けん将	固有一般
けんじ	けん将	固有人名
わかまつだいき	若松大樹	固有一般
わかやたくみ	若谷拓海	固有一般
わきひろき	脇裕基	固有一般
わきざかやすと	脇坂泰斗	固有一般
やすと	泰斗	固有人名
わきざかりょうへい	脇坂崚平	固有一般
りょうへい	崚平	固有人名
わきたにしずか	脇谷静香	固有一般
しずか	静香	固有人名
わきもとこうせい	脇本晃成	固有一般
こうせい	晃成	固有人名
わくたくみ	和久匠	固有一般
わくいとしひろ	涌井寿大	固有一般
としひろ	寿大	固有人名
わけしまゆたか	分島諒	固有一般
ゆたか	諒	固有人名
わこなおき	輪湖直樹	固有一般
わしだまさかず	鷲田雅一	固有一般
まさかず	雅一	固有人名
わたいまさき	渡井理己	固有一般
まさき	理己	固有人名
わただみつとし	和多田充寿	固有一般
みつとし	充寿	固有人名
わたなべあつお	渡辺敦夫	固有一般
あつお	敦夫	固有人名
わたなべあらた	渡邉新太	固有一般
わたなべいっぺい	渡辺一平	固有一般
わたなべえいすけ	渡邉英祐	固有一般
えいすけ	英祐	固有人名
わたなべおだい	渡辺桜大	固有一般
おだい	桜大	固有人名
わたなべかいと	渡邉海翔	固有一般
わたなべかいと	渡部快斗	固有一般
わたなべかずひと	渡邊一仁	固有一般
わたなべかずま	渡邉千真	固有一般
かずま	千真	固有人名
わたなべけいか	渡邊啓佳	固有一般
けいか	啓佳	固有人名
わたなべけいじ	渡邊圭二	固有一般
わたなべけんた	渡辺健太	固有一般
わたなべこうた	渡辺皓太	固有一般
こうた	皓太	固有人名
わたなべこうだい	渡辺広大	固有一般
わたなべしもん	渡邉志門	固有一般
しもん	志門	固有人名
わたなべしゅうと	渡邉柊斗	固有一般
わたなべしゅや	渡辺嵩也	固有一般
しゅや	嵩也	固有人名
わたなべじゅんいち	渡辺淳一	固有一般
わたなべすすむ	渡辺晋	固有一般
わたなべそうた	渡邊創太	固有一般
わたなべたいき	渡邊泰基	固有一般
たいき	泰基	固有人名
わたなべたいじゅ	渡部大樹	固有一般
わたなべたかまさ	渡辺隆正	固有一般
たかまさ	隆正	固有人名
わたなべたく	渡辺卓	固有一般
わたなべたく	渡辺拓	固有一般
わたなべたくみ	渡辺匠	固有一般
わたなべたけし	渡辺毅	固有一般
わたなべだいごう	渡邉大剛	固有一般
だいごう	大剛	固有人名
わたなべつよし	渡辺剛	固有一般
わたなべてった	渡辺哲多	固有一般
てった	哲多	固有人名
わたなべともき	渡邊知生	固有一般
ともき	知生	固有人名
わたなべとるく	渡部飛駆	固有一般
とるく	飛駆	固有人名
わたなべなおき	渡邉尚樹	固有一般
なおき	尚樹	固有人名
わたなべなつひこ	渡辺夏彦	固有一般
なつひこ	夏彦	固有人名
わたなべひでとよ	渡邉英豊	固有一般
ひでとよ	英豊	固有人名
わたなべひろふみ	渡部博文	固有一般
わたなべひろや	渡部広也	固有一般
ひろや	広也	固有人名
わたなべまこと	渡辺誠	固有一般
わたなべまさき	渡邉将基	固有一般
わたなべまさとも	渡邉真智	固有一般
まさとも	真智	固有人名
わたなべまなぶ	渡部学	固有一般
わたなべまひろ	渡邊真宏	固有一般
まひろ	真宏	固有人名
わたなべみつき	渡邉三城	固有一般
みつき	三城	固有人名
わたなべみつてる	渡辺光輝	固有一般
わたなべやすひろ	渡辺泰広	固有一般
わたなべゆうが	渡辺悠雅	固有一般
ゆうが	悠雅	固有人名
わたなべよう	渡辺陽	固有一般
よう	陽	固有人名
わたなべよしたか	渡辺佳孝	固有一般
よしたか	佳孝	固有人名
わたなべりう	渡邉吏海	固有一般
りう	吏海	固有人名
わたなべりき	渡辺力樹	固有一般
りき	力樹	固有人名
わたなべりゅうと	渡部琉翔	固有一般
りゅうと	琉翔	固有人名
わたなべりょう	渡邉りょう	固有一般
わたなべりょう	渡邊龍	固有一般
わたなべりょうた	渡辺亮太	固有一般
わたなべりょうま	渡邊凌磨	固有一般
りょうま	凌磨	固有人名
わたひきこう	綿引康	固有一般
こう	康	固有人名
わたべあれき	渡部一歴	固有一般
あれき	一歴	固有人名
わたべだいすけ	渡部大輔	固有一般
わたりだいき	渡大生	固有一般
だいき	大生	固有人名
わだあつき	和田篤紀	固有一般
あつき	篤紀	固有人名
わだかんた	和田幹大	固有一般
わだきらと	和田輝斗	固有一般
きらと	輝斗	固有人名
わだけんたろう	和田健太郎	固有一般
わだこうせい	和田晃生	固有一般
わだじゅん	和田潤	固有一般
わだたくみ	和田拓三	固有一般
たくみ	拓三	固有人名
わだたくや	和田拓也	固有一般
わだたつや	和田達也	固有一般
わだともき	和田倫季	固有一般
ともき	倫季	固有人名
わだはぐみ	和田育	固有一般
はぐみ	育	固有人名
わだはる	和田悠	固有一般
わだひびき	和田響稀	固有一般
ひびき	響稀	固有人名
わだまさし	和田昌士	固有一般
まさし	昌士	固有人名
わだまさひろ	和田昌裕	固有一般
まさひろ	昌裕	固有人名
わだゆうき	和田侑樹	固有一般
わだゆうせい	和田悠青	固有一般
ゆうせい	悠青	固有人名
わだゆうぞう	和田雄三	固有一般
わだりょう	和田凌	固有一般
わなみともひろ	和波智広	固有一般
わんしょうほう	王暁峰	固有一般
しょうほう	暁峰	固有人名
わんじんびん	王靖斌	固有一般
じんびん	靖斌	固有人名
わんじあん	王嘉楠	固有一般
じあん	嘉楠	固有人名